name	class
ACAMPROSATE	ALCOHOL DETERRENTS
DISULFIRAM	ALCOHOL DETERRENTS
NALTREXONE	ALCOHOL DETERRENTS
CYANIDE ANTIDOTE PACKAGE	CYANIDE ANTIDOTES
METHYLENE BLUE	CYANIDE ANTIDOTES
DEFEROXAMINE  MESYLATE	HEAVY METAL ANTAGONISTS
DIMERCAPROL	HEAVY METAL ANTAGONISTS
EDETATE CALCIUM DISODIUM	HEAVY METAL ANTAGONISTS
SODIUM POLYSTYRENE SULFONATE	ANTIDOTES,DETERRENTS,AND POISON CONTROL EXCHANGE RESINS
SODIUM POLYSTYRENE SULFONATE	ANTIDOTES,DETERRENTS,AND POISON CONTROL EXCHANGE RESINS
ACETYLCYSTEINE	#N/A
CHARCOAL ACTIVATED  (OTC)	ANTIDOTES/DETERRENTS,OTHER
CHARCOAL ACTIVATED IN SORBITOL (OTC)	ANTIDOTES/DETERRENTS,OTHER
DEXTRAN 1	ANTIDOTES/DETERRENTS,OTHER
DIGOXIN IMMUNE FAB (OVINE)	ANTIDOTES/DETERRENTS,OTHER
FLUMAZENIL	ANTIDOTES/DETERRENTS,OTHER
FOMEPIZOLE	ANTIDOTES/DETERRENTS,OTHER
INSECT STING TREATMENT KIT	ANTIDOTES/DETERRENTS,OTHER
MESNA	ANTIDOTES/DETERRENTS,OTHER
NICOTINE	ANTIDOTES/DETERRENTS,OTHER
NICOTINE	ANTIDOTES/DETERRENTS,OTHER
NICOTINE POLACRILEX	ANTIDOTES/DETERRENTS,OTHER
PRALIDOXIME CL	ANTIDOTES/DETERRENTS,OTHER
VARENICLINE TARTRATE	ANTIDOTES/DETERRENTS,OTHER
PROMETHAZINE HCL	ANTIHISTAMINES,PHENOTHIAZINE
PROMETHAZINE HCL	ANTIHISTAMINES,PHENOTHIAZINE
PROMETHAZINE HCL	ANTIHISTAMINES,PHENOTHIAZINE
DIPHENHYDRAMINE HCL	ANTIHISTAMINES,ETHANOLAMINE
DIPHENHYDRAMINE HCL (OTC)	ANTIHISTAMINES,ETHANOLAMINE
CHLORPHENIRAMINE MALEATE (OTC)	ANTIHISTAMINES,ALKYLAMINE
CHLORPHENIRAMINE MALEATE (OTC)	ANTIHISTAMINES,ALKYLAMINE
CHLORPHENIRAMINE MALEATE (OTC)	ANTIHISTAMINES,ALKYLAMINE
CETIRIZINE	ANTIHISTAMINES,PIPERAZINE
HYDROXYZINE	ANTIHISTAMINES,PIPERAZINE
HYDROXYZINE	ANTIHISTAMINES,PIPERAZINE
HYDROXYZINE	ANTIHISTAMINES,PIPERAZINE
CYPROHEPTADINE	ANTIHISTAMINES,PIPERIDINE
LORATIDINE	ANTIHISTAMINES,OTHER
DIPHENHYDRAMINE HCL (OTC)	#N/A
PENICILLIN	PENICILLIN-G RELATED PENICILLINS
PENICILLIN	PENICILLIN-G RELATED PENICILLINS
PENICILLIN G BENZATHINE	PENICILLIN-G RELATED PENICILLINS
PENICILLIN G POTASSIUM	PENICILLIN-G RELATED PENICILLINS
PENICILLIN G PROCAINE	PENICILLIN-G RELATED PENICILLINS
AMOXICILLIN	PENICILLINS,AMINO DERIVATIVES
AMOXICILLIN	PENICILLINS,AMINO DERIVATIVES
AMOXICILLIN/CLAVULANATE K	PENICILLINS,AMINO DERIVATIVES
AMOXICILLIN/CLAVULANATE K	PENICILLINS,AMINO DERIVATIVES
AMPICILLIN NA	PENICILLINS,AMINO DERIVATIVES
AMPICILLIN NA/SULBACTAM NA	PENICILLINS,AMINO DERIVATIVES
DICLOXACILLIN NA	PENICILLINASE-RESISTANT PENICILLINS
NAFCILLIN NA	PENICILLINASE-RESISTANT PENICILLINS
OXACILLIN	PENICILLINASE-RESISTANT PENICILLINS
PIPERACILLIN NA	EXTENDED SPECTRUM PENICILLINS
PIPERACILLIN NA/TAZOBACTAM	EXTENDED SPECTRUM PENICILLINS
TICARCILLIN/CLAVULANATE K	EXTENDED SPECTRUM PENICILLINS
CEFAZOLIN	CEPHALOSPORIN 1ST GENERATION
CEPHALEXIN	CEPHALOSPORIN 1ST GENERATION
CEFACLOR	CEPHALOSPORIN 2ND GENERATION
CEFOTETAN	CEPHALOSPORIN 2ND GENERATION
CEFOXITIN NA	CEPHALOSPORIN 2ND GENERATION
CEFPODOXIME PROXETIL	CEPHALOSPORIN 2ND GENERATION
CEFUROXIME AXETIL	CEPHALOSPORIN 2ND GENERATION
CEFDINIR	CEPHALOSPORIN 3RD GENERATION
CEFIXIME	CEPHALOSPORIN 3RD GENERATION
CEFOTAXIME	CEPHALOSPORIN 3RD GENERATION
CEFTAZIDIME	CEPHALOSPORIN 3RD GENERATION
CEFTIZOXIME	CEPHALOSPORIN 3RD GENERATION
CEFTRIAXONE NA	CEPHALOSPORIN 3RD GENERATION
CEFEPIME	CEPHALOSPORIN 4TH GENERATION
AZTREONAM	BETA-LACTAMS ANTIMICROBIALS,OTHER
CEFTAROLINE	BETA-LACTAMS ANTIMICROBIALS,OTHER
ERTAPENEM	BETA-LACTAMS ANTIMICROBIALS,OTHER
IMIPENEM/CILASTATIN NA	BETA-LACTAMS ANTIMICROBIALS,OTHER
MEROPENEM	BETA-LACTAMS ANTIMICROBIALS,OTHER
CHLORAMPHENICOL	CHLORAMPHENICOL
AZITHROMYCIN	ERYTHROMYCINS/MACROLIDES
AZITHROMYCIN	ERYTHROMYCINS/MACROLIDES
AZITHROMYCIN	ERYTHROMYCINS/MACROLIDES
CLARITHROMYCIN	ERYTHROMYCINS/MACROLIDES
ERYTHROMYCIN	ERYTHROMYCINS/MACROLIDES
ERYTHROMYCIN	ERYTHROMYCINS/MACROLIDES
ERYTHROMYCIN	ERYTHROMYCINS/MACROLIDES
ERYTHROMYCIN LACTOBIONATE	ERYTHROMYCINS/MACROLIDES
DEMECLOCYCLINE HCL	TETRACYCLINES
DOXYCYCLINE	TETRACYCLINES
DOXYCYCLINE	TETRACYCLINES
DOXYCYCLINE HYCLATE	TETRACYCLINES
MINOCYCLINE HCL	TETRACYCLINES
TETRACYCLINE HCL	TETRACYCLINES
TIGECYCLINE	TETRACYCLINES
AMIKACIN SULFATE	AMINOGLYCOSIDES
GENTAMICIN SO4	AMINOGLYCOSIDES
KANAMYCIN	AMINOGLYCOSIDES
NEOMYCIN SULFATE	AMINOGLYCOSIDES
STREPTOMYCIN SULFATE	AMINOGLYCOSIDES
TOBRAMYCIN SULFATE	AMINOGLYCOSIDES
CLINDAMYCIN	LINCOMYCINS
CLINDAMYCIN PALMITATE SOLN	LINCOMYCINS
CLINDAMYCIN PHOSPHATE	LINCOMYCINS
CIPROFLOXACIN	QUINOLONES
CIPROFLOXACIN HCL	QUINOLONES
LEVOFLOXACIN	QUINOLONES
LEVOFLOXACIN	QUINOLONES
MOXIFLOXACIN	QUINOLONES
MOXIFLOXACIN	QUINOLONES
CAPREOMYCIN INJ	ANTITUBERCULARS
CYCLOSERINE	ANTITUBERCULARS
ETHAMBUTOL HCL	ANTITUBERCULARS
ETHIONAMIDE	ANTITUBERCULARS
ISONIAZID	ANTITUBERCULARS
ISONIAZID	ANTITUBERCULARS
ISONIAZID/RIFAMPIN	ANTITUBERCULARS
PYRAZINAMIDE	ANTITUBERCULARS
RIFAMPIN	ANTITUBERCULARS
RIFAMPIN	ANTITUBERCULARS
RIFAPENTINE	ANTITUBERCULARS
METHENAMINE	METHENAMINE SALTS ANTIMICROBIALS
NITROFURANTOIN MONOHYDRATE/MACROCRYSTALLINE	NITROFURANS ANTIMICROBIALS
SULFADIAZINE	SULFONAMIDE/RELATED ANTIMICROBIALS
SULFAMETHOXAZOLE/TRIMETHOPRIM	SULFONAMIDE/RELATED ANTIMICROBIALS
SULFAMETHOXAZOLE/TRIMETHOPRIM	SULFONAMIDE/RELATED ANTIMICROBIALS
SULFAMETHOXAZOLE/TRIMETHOPRIM	SULFONAMIDE/RELATED ANTIMICROBIALS
AMPHOTERICIN B	ANTIFUNGALS
AMPHOTERICIN B LIPOSOMAL	ANTIFUNGALS
FLUCONAZOLE	ANTIFUNGALS
FLUCONAZOLE	ANTIFUNGALS
FLUCONAZOLE	ANTIFUNGALS
FLUCYTOSINE	ANTIFUNGALS
ITRACONAZOLE ORAL	ANTIFUNGALS
KETOCONAZOLE	ANTIFUNGALS
MICAFUNGIN	ANTIFUNGALS
NYSTATIN	ANTIFUNGALS
NYSTATIN	ANTIFUNGALS
TERBINAFINE HCL	ANTIFUNGALS
ABACAVIR	ANTIVIRALS
ABACAVIR	ANTIVIRALS
ABACAVIR/DOLUTEGRAVIR/LAMIVUDINE	ANTIVIRALS
ABACAVIR/LAMIVUDINE	ANTIVIRALS
ABACAVIR/LAMIVUDINE/ZIDOVUDINE	ANTIVIRALS
ACYCLOVIR	ANTIVIRALS
ACYCLOVIR	ANTIVIRALS
ACYCLOVIR	ANTIVIRALS
ADEFOVIR	ANTIVIRALS
AMANTADINE HCL	ANTIVIRALS
AMANTADINE HCL	ANTIVIRALS
ATAZANIVIR	ANTIVIRALS
CIDOFOVIR	ANTIVIRALS
COBICISTAT/DARUNAVIR	ANTIVIRALS
COBICISTAT/ELVITEGRAVIR/EMTRICITABINE/TENOFOVIR 	ANTIVIRALS
DARUNAVIR ETHANOLATE	ANTIVIRALS
DASABUVIR/OMBITASVIR/PARITAPREVIR/RITONAVIR	ANTIVIRALS
DELAVIRDINE	ANTIVIRALS
DIDANOSINE	ANTIVIRALS
DOLUTEGRAVIR	ANTIVIRALS
EFAVIRENZ	ANTIVIRALS
EFAVIRENZ	ANTIVIRALS
EFAVIRENZ/EMTRICITABINE/TENOFOVIR	ANTIVIRALS
EMTRICITABINE	ANTIVIRALS
EMTRICITABINE/RILPIVIRINE/TENOFOVIR	ANTIVIRALS
EMTRICITABINE/TENOFOVIR	ANTIVIRALS
ENFUVIRTIDE	ANTIVIRALS
ENTECAVIR	ANTIVIRALS
ENTECAVIR	ANTIVIRALS
ETRAVIRINE	ANTIVIRALS
FAMCICLOVIR	ANTIVIRALS
FOSAMPRENAVIR	ANTIVIRALS
GANCICLOVIR	ANTIVIRALS
INDINAVIR S04	ANTIVIRALS
INTERFERON ALFA-2B INJ/RIBAVIRIN	ANTIVIRALS
LAMIVUDINE	ANTIVIRALS
LAMIVUDINE	ANTIVIRALS
LAMIVUDINE/ZIDOVUDINE	ANTIVIRALS
LEDIPASVIR/SOFOSBUVIR	ANTIVIRALS
LOPINAVIR/RITONAVIR	ANTIVIRALS
MARAVIROC	ANTIVIRALS
NELFINAVIR	ANTIVIRALS
NEVIRAPINE	ANTIVIRALS
OSELTAMIVIR	ANTIVIRALS
RALTEGRAVIR	ANTIVIRALS
RIBAVIRIN	ANTIVIRALS
RIBAVIRIN	ANTIVIRALS
RILPIVIRINE	ANTIVIRALS
RIMANTADINE HCL	ANTIVIRALS
RITONAVIR	ANTIVIRALS
RITONAVIR	ANTIVIRALS
SAQUINAVIR	ANTIVIRALS
SAQUINAVIR	ANTIVIRALS
SIMEPREVIR	ANTIVIRALS
SOFOSBUVIR	ANTIVIRALS
STAVUDINE (d4T)	ANTIVIRALS
TENOFOVIR DISOPROXIL FUMARATE	ANTIVIRALS
TIPRANAVIR	ANTIVIRALS
VALACYCLOVIR	ANTIVIRALS
VALGANCICLOVIR HCL	ANTIVIRALS
ZANAMIVIR	ANTIVIRALS
ZIDOVUDINE	ANTIVIRALS
ZIDOVUDINE	ANTIVIRALS
ZIDOVUDINE	ANTIVIRALS
BACITRACIN	ANTI-INFECTIVES,OTHER
DALFOPRISTIN/QUINUPRISTIN	ANTI-INFECTIVES,OTHER
DAPSONE	ANTI-INFECTIVES,OTHER
DAPTOMYCIN	ANTI-INFECTIVES,OTHER
LINEZOLID	ANTI-INFECTIVES,OTHER
LINEZOLID	ANTI-INFECTIVES,OTHER
LINEZOLID	ANTI-INFECTIVES,OTHER
METRONIDAZOLE	ANTI-INFECTIVES,OTHER
METRONIDAZOLE	ANTI-INFECTIVES,OTHER
PENTAMIDINE ISETHIONATE	ANTI-INFECTIVES,OTHER
POLYMYXIN B SO4	ANTI-INFECTIVES,OTHER
RIFABUTIN	ANTI-INFECTIVES,OTHER
TRIMETHOPRIM	ANTI-INFECTIVES,OTHER
VANCOMYCIN	ANTI-INFECTIVES,OTHER
VANCOMYCIN HCL	ANTI-INFECTIVES,OTHER
BUSULFAN	ANTINEOPLASTICS,ALKYLATING AGENTS
BUSULFAN	ANTINEOPLASTICS,ALKYLATING AGENTS
CARMUSTINE	ANTINEOPLASTICS,ALKYLATING AGENTS
CHLORAMBUCIL	ANTINEOPLASTICS,ALKYLATING AGENTS
CYCLOPHOSPHAMIDE	ANTINEOPLASTICS,ALKYLATING AGENTS
CYCLOPHOSPHAMIDE	ANTINEOPLASTICS,ALKYLATING AGENTS
IFOSFAMIDE	ANTINEOPLASTICS,ALKYLATING AGENTS
IFOSFAMIDE/MESNA	ANTINEOPLASTICS,ALKYLATING AGENTS
LOMUSTINE	ANTINEOPLASTICS,ALKYLATING AGENTS
MECHLORETHAMINE	ANTINEOPLASTICS,ALKYLATING AGENTS
MELPHALAN	ANTINEOPLASTICS,ALKYLATING AGENTS
MELPHALAN HCL	ANTINEOPLASTICS,ALKYLATING AGENTS
THIOTEPA	ANTINEOPLASTICS,ALKYLATING AGENTS
BLEOMYCIN SO4	ANTINEOPLASTIC ANTIBIOTICS
DACTINOMYCIN	ANTINEOPLASTIC ANTIBIOTICS
DAUNORUBICIN	ANTINEOPLASTIC ANTIBIOTICS
DOXORUBICIN	ANTINEOPLASTIC ANTIBIOTICS
IDARUBICIN	ANTINEOPLASTIC ANTIBIOTICS
MITOMYCIN	ANTINEOPLASTIC ANTIBIOTICS
STREPTOZOCIN	ANTINEOPLASTIC ANTIBIOTICS
AZACITIDINE	ANTINEOPLASTICS,ANTIMETABOLITES
CAPECITABINE	ANTINEOPLASTICS,ANTIMETABOLITES
CLADRIBINE	ANTINEOPLASTICS,ANTIMETABOLITES
CYTARABINE	ANTINEOPLASTICS,ANTIMETABOLITES
FLUDARABINE	ANTINEOPLASTICS,ANTIMETABOLITES
FLUOROURACIL	ANTINEOPLASTICS,ANTIMETABOLITES
HYDROXYUREA	ANTINEOPLASTICS,ANTIMETABOLITES
MERCAPTOPURINE	ANTINEOPLASTICS,ANTIMETABOLITES
METHOTREXATE NA	ANTINEOPLASTICS,ANTIMETABOLITES
METHOTREXATE NA	ANTINEOPLASTICS,ANTIMETABOLITES
THIOGUANINE	ANTINEOPLASTICS,ANTIMETABOLITES
LEUPROLIDE (EQV-ELIGARD)	ANTINEOPLASTIC HORMONES
TAMOXIFEN CITRATE	ANTINEOPLASTIC HORMONES
DEXRAZOXANE	PROTECTIVE AGENTS
ANASTROZOLE	ANTINEOPLASTIC,OTHER
ASPARAGINASE	ANTINEOPLASTIC,OTHER
BCG,TICE VACCINE	ANTINEOPLASTIC,OTHER
BEVACIZUMAB	ANTINEOPLASTIC,OTHER
BICALUTAMIDE	ANTINEOPLASTIC,OTHER
BORTEZOMIB	ANTINEOPLASTIC,OTHER
CARBOPLATIN INJ	ANTINEOPLASTIC,OTHER
CISPLATIN	ANTINEOPLASTIC,OTHER
DACARBAZINE	ANTINEOPLASTIC,OTHER
DOCETAXEL	ANTINEOPLASTIC,OTHER
ESTRAMUSTINE	ANTINEOPLASTIC,OTHER
ETOPOSIDE	ANTINEOPLASTIC,OTHER
ETOPOSIDE	ANTINEOPLASTIC,OTHER
FLUTAMIDE	ANTINEOPLASTIC,OTHER
GEMCITABINE	ANTINEOPLASTIC,OTHER
IMATINIB MESYLATE	ANTINEOPLASTIC,OTHER
IRINOTECAN	ANTINEOPLASTIC,OTHER
LETROZOLE	ANTINEOPLASTIC,OTHER
MITOTANE	ANTINEOPLASTIC,OTHER
MITOXANTRONE	ANTINEOPLASTIC,OTHER
OXALIPLATIN	ANTINEOPLASTIC,OTHER
PACLITAXEL	ANTINEOPLASTIC,OTHER
PENTOSTATIN	ANTINEOPLASTIC,OTHER
PENTOSTATIN/MANNITOL	ANTINEOPLASTIC,OTHER
PERTUZUMAB	ANTINEOPLASTIC,OTHER
PORFIMER SODIUM	ANTINEOPLASTIC,OTHER
PROCARBAZINE	ANTINEOPLASTIC,OTHER
RITUXIMAB	ANTINEOPLASTIC,OTHER
TENIPOSIDE	ANTINEOPLASTIC,OTHER
TOPOTECAN	ANTINEOPLASTIC,OTHER
TRASTUZUMAB	ANTINEOPLASTIC,OTHER
VINBLASTINE	ANTINEOPLASTIC,OTHER
VINCRISTINE	ANTINEOPLASTIC,OTHER
VINORELBINE	ANTINEOPLASTIC,OTHER
ZIV-AFLIBERCEPT	ANTINEOPLASTIC,OTHER
ATOVAQUONE/PROGUANIL	ANTIMALARIALS
HYDROXYCHLOROQUINE SULFATE	ANTIMALARIALS
PRIMAQUINE PHOSPHATE	ANTIMALARIALS
PYRIMETHAMINE	ANTIMALARIALS
ATOVAQUONE	ANTIPROTOZOALS,OTHER
PENTAMIDINE ISETHIONATE	ANTIPROTOZOALS,OTHER
ALBENDAZOLE	ANTHELMINTICS
IVERMECTIN	ANTHELMINTICS
PERMETHRIN (OTC)	PEDICULICIDES
PERMETHRIN (OTC)	PEDICULICIDES
DOBUTAMINE	SYMPATHOMIMETICS (ADRENERGICS)
DOPAMINE	SYMPATHOMIMETICS (ADRENERGICS)
EPHEDRINE	SYMPATHOMIMETICS (ADRENERGICS)
EPINEPHRINE	SYMPATHOMIMETICS (ADRENERGICS)
FENOLDOPAM	SYMPATHOMIMETICS (ADRENERGICS)
ISOPROTERENOL	SYMPATHOMIMETICS (ADRENERGICS)
NOREPINEPHRINE	SYMPATHOMIMETICS (ADRENERGICS)
PHENYLEPHRINE	SYMPATHOMIMETICS (ADRENERGICS)
TERBUTALINE SULFATE	SYMPATHOMIMETICS (ADRENERGICS)
PHENOXYBENZAMINE HCL	SYMPATHOLYTICS
PHENTOLAMINE MESYLATE	SYMPATHOLYTICS
BETHANECHOL CHLORIDE	PARASYMPATHOMIMETICS (CHOLINERGICS)
BETHANECHOL CHLORIDE	PARASYMPATHOMIMETICS (CHOLINERGICS)
EDROPHONIUM CHLORIDE	PARASYMPATHOMIMETICS (CHOLINERGICS)
METOCLOPRAMIDE HCL	PARASYMPATHOMIMETICS (CHOLINERGICS)
METOCLOPRAMIDE HCL	PARASYMPATHOMIMETICS (CHOLINERGICS)
METOCLOPRAMIDE HCL INJ	PARASYMPATHOMIMETICS (CHOLINERGICS)
NEOSTIGMINE BROMIDE	PARASYMPATHOMIMETICS (CHOLINERGICS)
NEOSTIGMINE METHYLSULFATE	PARASYMPATHOMIMETICS (CHOLINERGICS)
PHYSOSTIGMINE SALICYLATE	PARASYMPATHOMIMETICS (CHOLINERGICS)
PILOCARPINE HCL	PARASYMPATHOMIMETICS (CHOLINERGICS)
PYRIDOSTIGMINE	PARASYMPATHOMIMETICS (CHOLINERGICS)
PYRIDOSTIGMINE	PARASYMPATHOMIMETICS (CHOLINERGICS)
PYRIDOSTIGMINE BROMIDE	PARASYMPATHOMIMETICS (CHOLINERGICS)
ATROPINE SO4	PARASYMPATHOLYTICS
BENZTROPINE MESYLATE	PARASYMPATHOLYTICS
BENZTROPINE MESYLATE	PARASYMPATHOLYTICS
DICYCLOMINE HCL	PARASYMPATHOLYTICS
DICYCLOMINE HCL	PARASYMPATHOLYTICS
DICYCLOMINE HCL	PARASYMPATHOLYTICS
DICYCLOMINE HCL	PARASYMPATHOLYTICS
GLYCOPYRROLATE	PARASYMPATHOLYTICS
PROPANTHELINE BR	PARASYMPATHOLYTICS
SCOPOLAMINE HBR	PARASYMPATHOLYTICS
TRIHEXYPHENIDYL	PARASYMPATHOLYTICS
BROMOCRIPTINE MESYLATE	AUTONOMIC AGENTS,OTHER
BROMOCRIPTINE MESYLATE	AUTONOMIC AGENTS,OTHER
APIXABAN	ANTICOAGULANTS
ARGATROBAN	ANTICOAGULANTS
BIVALIRUDIN	ANTICOAGULANTS
DABIGATRAN	ANTICOAGULANTS
DALTEPARIN	ANTICOAGULANTS
ENOXAPARIN	ANTICOAGULANTS
EPTIFIBATIDE	ANTICOAGULANTS
FONDAPARINUX	ANTICOAGULANTS
HEPARIN	ANTICOAGULANTS
RIVAROXABAN	ANTICOAGULANTS
TIROFIBAN	ANTICOAGULANTS
WARFARIN NA	ANTICOAGULANTS
ALTEPLASE, RECOMBINANT	THROMBOLYTICS
RETEPLASE	THROMBOLYTICS
STREPTOKINASE	THROMBOLYTICS
TENECTEPLASE,RECOMBINANT	THROMBOLYTICS
UROKINASE 5000U	THROMBOLYTICS
AMINOCAPROIC ACID	ANTIHEMORRHAGICS
AMINOCAPROIC ACID	ANTIHEMORRHAGICS
GELATIN,ABSORBABLE	ANTIHEMORRHAGICS
GELATIN,ABSORBABLE	ANTIHEMORRHAGICS
GELATIN,ABSORBABLE	ANTIHEMORRHAGICS
GELATIN,ABSORBABLE	ANTIHEMORRHAGICS
PROTHROMBIN COMPLEX CONCENTRATE (4-FACTOR)	ANTIHEMORRHAGICS
THROMBIN	ANTIHEMORRHAGICS
ABCIXIMAB	PLATELET AGGREGATION INHIBITORS
ASPIRIN/DIPYRIDAMOLE	PLATELET AGGREGATION INHIBITORS
CLOPIDOGREL BISULFATE	PLATELET AGGREGATION INHIBITORS
DIPYRIDAMOLE	PLATELET AGGREGATION INHIBITORS
PROTAMINE SO4	HEPARIN ANTAGONISTS
TRANEXAMIC ACID	#N/A
ANAGRELIDE	BLOOD FORMATION PRODUCTS
DARBEPOETIN ALFA RECOMBINANT	BLOOD FORMATION PRODUCTS
EPOETIN ALFA,RECOMBINANT	BLOOD FORMATION PRODUCTS
FILGRASTIM	BLOOD FORMATION PRODUCTS
FILGRASTIM-(TBO)	BLOOD FORMATION PRODUCTS
SARGRAMOSTIM	BLOOD FORMATION PRODUCTS
ALBUMIN,HUMAN	BLOOD DERIVATIVES
ANTIHEMOPHILIC FACTOR,HUMAN	BLOOD DERIVATIVES
FACTOR IX COMPLEX, HUMAN	BLOOD DERIVATIVES
PLASMA PROTEIN FRACTION 5%	BLOOD DERIVATIVES
DEXTRAN 40	VOLUME EXPANDERS
DEXTRAN 70	VOLUME EXPANDERS
DEXTRAN 75	VOLUME EXPANDERS
DEXTRAN HM	VOLUME EXPANDERS
HETASTARCH	VOLUME EXPANDERS
HETASTARCH/ELECTROLYTES	VOLUME EXPANDERS
ACETAMINOPHEN/HYDROCODONE	OPIOID ANALGESICS
ACETAMINOPHEN/HYDROCODONE	OPIOID ANALGESICS
ACETAMINOPHEN/OXYCODONE HCL	OPIOID ANALGESICS
ACETAMINOPHEN/OXYCODONE HCL	OPIOID ANALGESICS
ACETAMINOPHEN/OXYCODONE HCL	OPIOID ANALGESICS
ALFENTANIL HCL	OPIOID ANALGESICS
BELLADONA/OPIUM	OPIOID ANALGESICS
BUPRENORPHINE	OPIOID ANALGESICS
BUPRENORPHINE/NALOXONE	OPIOID ANALGESICS
BUTORPHANOL TARTRATE	OPIOID ANALGESICS
CODEINE	OPIOID ANALGESICS
CODEINE/ACETAMINOPHEN	OPIOID ANALGESICS
CODEINE/ACETAMINOPHEN	OPIOID ANALGESICS
FENTANYL	OPIOID ANALGESICS
FENTANYL CITRATE	OPIOID ANALGESICS
HYDROMORPHONE HCL	OPIOID ANALGESICS
HYDROMORPHONE HCL	OPIOID ANALGESICS
MEPERIDINE HCL	OPIOID ANALGESICS
METHADONE HCL	OPIOID ANALGESICS
METHADONE HCL	OPIOID ANALGESICS
MORPHINE	OPIOID ANALGESICS
MORPHINE	OPIOID ANALGESICS
MORPHINE	OPIOID ANALGESICS
MORPHINE	OPIOID ANALGESICS
MORPHINE	OPIOID ANALGESICS
MORPHINE	OPIOID ANALGESICS
MORPHINE	OPIOID ANALGESICS
OXYCODONE HCL	OPIOID ANALGESICS
OXYCODONE HCL	OPIOID ANALGESICS
REMIFENTANIL	OPIOID ANALGESICS
SUFENTANIL CITRATE	OPIOID ANALGESICS
NALOXONE (AUTOINJECTOR)	OPIOID ANTAGONIST ANALGESICS
NALOXONE HCL	OPIOID ANTAGONIST ANALGESICS
NALOXONE RESCUE INTRAMUSCULAR	OPIOID ANTAGONIST ANALGESICS
NALOXONE RESCUE INTRANASAL	OPIOID ANTAGONIST ANALGESICS
NALTREXONE HCL	OPIOID ANTAGONIST ANALGESICS
ACETAMINOPHEN	NON-OPIOID ANALGESICS
ACETAMINOPHEN	NON-OPIOID ANALGESICS
ACETAMINOPHEN	NON-OPIOID ANALGESICS
ACETAMINOPHEN	NON-OPIOID ANALGESICS
ACETAMINOPHEN/BUTALBITAL/CAFFEINE	NON-OPIOID ANALGESICS
ASPIRIN	NON-OPIOID ANALGESICS
ASPIRIN (OTC)	NON-OPIOID ANALGESICS
ASPIRIN (OTC)	NON-OPIOID ANALGESICS
ASPIRIN (OTC)	NON-OPIOID ANALGESICS
ASPIRIN BUFFERED (OTC)	NON-OPIOID ANALGESICS
ASPIRIN/BUTALBITAL/CAFFEINE	NON-OPIOID ANALGESICS
ASPIRIN/BUTALBITAL/CAFFEINE	NON-OPIOID ANALGESICS
CLONIDINE HCL	NON-OPIOID ANALGESICS
TRAMADOL HCL	NON-OPIOID ANALGESICS
CAFFEINE/ERGOTAMINE	ANTIMIGRAINE AGENTS
CAFFEINE/ERGOTAMINE	ANTIMIGRAINE AGENTS
DIHYDROERGOTAMINE MESYLATE	ANTIMIGRAINE AGENTS
SUMATRIPTAN SUCCINATE	ANTIMIGRAINE AGENTS
SUMATRIPTAN SUCCINATE	ANTIMIGRAINE AGENTS
ENFLURANE	ANESTHETICS,INHALATION
HALOTHANE INHALATION	ANESTHETICS,INHALATION
ISOFLURANE	ANESTHETICS,INHALATION
METHOHEXITAL	BARBITURIC ACID DERIVATIVE ANESTHETICS
THIOPENTAL	BARBITURIC ACID DERIVATIVE ANESTHETICS
DESFLURANE	GENERAL ANESTHETICS,OTHER
ETOMIDATE	GENERAL ANESTHETICS,OTHER
KETAMINE	GENERAL ANESTHETICS,OTHER
PROPOFOL	GENERAL ANESTHETICS,OTHER
SEVOFLURANE	GENERAL ANESTHETICS,OTHER
ARTICAINE/EPINEPHRINE	LOCAL ANESTHETICS,INJECTION
BUPIVACAINE HCL	LOCAL ANESTHETICS,INJECTION
BUPIVACAINE/DEXTROSE	LOCAL ANESTHETICS,INJECTION
BUPIVACAINE/EPINEPHRINE	LOCAL ANESTHETICS,INJECTION
CHLOROPROCAINE HCL	LOCAL ANESTHETICS,INJECTION
LIDOCAINE HCL	LOCAL ANESTHETICS,INJECTION
LIDOCAINE HCL/EPINEPHRINE	LOCAL ANESTHETICS,INJECTION
MEPIVACAINE HCL	LOCAL ANESTHETICS,INJECTION
PRILOCAINE	LOCAL ANESTHETICS,INJECTION
PRILOCAINE HCL/EPINEPHRINE	LOCAL ANESTHETICS,INJECTION
PROCAINE HCL	LOCAL ANESTHETICS,INJECTION
ROPIVACAINE	LOCAL ANESTHETICS,INJECTION
TETRACAINE HCL	LOCAL ANESTHETICS,INJECTION
DROPERIDOL	ANESTHETIC ADJUNCTS
PHENOBARBITAL	BARBITURIC ACID DERIVATIVE SEDATIVES/HYPNOTICS
PHENOBARBITAL	BARBITURIC ACID DERIVATIVE SEDATIVES/HYPNOTICS
PHENOBARBITAL	BARBITURIC ACID DERIVATIVE SEDATIVES/HYPNOTICS
ALPRAZOLAM	BENZODIAZEPINE DERIVATIVE SEDATIVES/HYPNOTICS
CHLORDIAZEPOXIDE HCL	BENZODIAZEPINE DERIVATIVE SEDATIVES/HYPNOTICS
DIAZEPAM	BENZODIAZEPINE DERIVATIVE SEDATIVES/HYPNOTICS
DIAZEPAM	BENZODIAZEPINE DERIVATIVE SEDATIVES/HYPNOTICS
LORAZEPAM INJ	BENZODIAZEPINE DERIVATIVE SEDATIVES/HYPNOTICS
LORAZEPAM ORAL	BENZODIAZEPINE DERIVATIVE SEDATIVES/HYPNOTICS
MIDAZOLAM HCL	BENZODIAZEPINE DERIVATIVE SEDATIVES/HYPNOTICS
TEMAZEPAM	BENZODIAZEPINE DERIVATIVE SEDATIVES/HYPNOTICS
BUSPIRONE HCL	SEDATIVES/HYPNOTICS,OTHER
DEXMEDETOMIDINE	SEDATIVES/HYPNOTICS,OTHER
ZOLPIDEM	SEDATIVES/HYPNOTICS,OTHER
CARBAMAZEPINE	ANTICONVULSANTS
CARBAMAZEPINE	ANTICONVULSANTS
CARBAMAZEPINE	ANTICONVULSANTS
CLONAZEPAM	ANTICONVULSANTS
DIVALPROEX NA	ANTICONVULSANTS
FELBAMATE	ANTICONVULSANTS
FELBAMATE	ANTICONVULSANTS
FOSPHENYTOIN NA	ANTICONVULSANTS
GABAPENTIN	ANTICONVULSANTS
GABAPENTIN	ANTICONVULSANTS
GABAPENTIN	ANTICONVULSANTS
LAMOTRIGINE	ANTICONVULSANTS
LEVETIRACETAM	ANTICONVULSANTS
LEVETIRACETAM	ANTICONVULSANTS
OXCARBAZEPINE	ANTICONVULSANTS
PHENYTOIN	ANTICONVULSANTS
PHENYTOIN	ANTICONVULSANTS
PHENYTOIN (MYLAN)	ANTICONVULSANTS
PHENYTOIN NA	ANTICONVULSANTS
PRIMIDONE	ANTICONVULSANTS
TOPIRAMATE	ANTICONVULSANTS
VALPROIC ACID	ANTICONVULSANTS
VALPROIC ACID	ANTICONVULSANTS
ZONISAMIDE	ANTICONVULSANTS
APOMORPHINE	ANTIPARKINSON AGENTS
CARBIDOPA /LEVODOPA	ANTIPARKINSON AGENTS
CARBIDOPA/LEVODOPA	ANTIPARKINSON AGENTS
ENTACAPONE	ANTIPARKINSON AGENTS
RASAGILINE	ANTIPARKINSON AGENTS
ROPINIROLE	ANTIPARKINSON AGENTS
SELEGILINE HCL	ANTIPARKINSON AGENTS
MECLIZINE HCL (OTC)	ANTIVERTIGO AGENTS
AMITRIPTYLINE HCL	TRICYCLIC ANTIDEPRESSANTS
CLOMIPRAMINE	TRICYCLIC ANTIDEPRESSANTS
DESIPRAMINE HCL	TRICYCLIC ANTIDEPRESSANTS
DOXEPIN HCL	TRICYCLIC ANTIDEPRESSANTS
DOXEPIN HCL	TRICYCLIC ANTIDEPRESSANTS
IMIPRAMINE HCL	TRICYCLIC ANTIDEPRESSANTS
NORTRIPTYLINE	TRICYCLIC ANTIDEPRESSANTS
NORTRIPTYLINE	TRICYCLIC ANTIDEPRESSANTS
PHENELZINE SULFATE	MONAMINE OXIDASE INHIBITOR ANTIDEPRESSANTS
SELEGILINE	MONAMINE OXIDASE INHIBITOR ANTIDEPRESSANTS
TRANYLCYPROMINE SULFATE	MONAMINE OXIDASE INHIBITOR ANTIDEPRESSANTS
BUPROPION HCL	ANTIDEPRESSANTS,OTHER
BUPROPION HCL	ANTIDEPRESSANTS,OTHER
CITALOPRAM HYDROBROMIDE	ANTIDEPRESSANTS,OTHER
CITALOPRAM HYDROBROMIDE	ANTIDEPRESSANTS,OTHER
DULOXETINE	ANTIDEPRESSANTS,OTHER
ESCITALOPRAM	ANTIDEPRESSANTS,OTHER
FLUOXETINE	ANTIDEPRESSANTS,OTHER
FLUOXETINE	ANTIDEPRESSANTS,OTHER
FLUOXETINE	ANTIDEPRESSANTS,OTHER
MIRTAZAPINE	ANTIDEPRESSANTS,OTHER
PAROXETINE	ANTIDEPRESSANTS,OTHER
SERTRALINE	ANTIDEPRESSANTS,OTHER
SERTRALINE	ANTIDEPRESSANTS,OTHER
TRAZODONE	ANTIDEPRESSANTS,OTHER
VENLAFAXINE (ER)	ANTIDEPRESSANTS,OTHER
VENLAFAXINE (IR)	ANTIDEPRESSANTS,OTHER
CHLORPROMAZINE	PHENOTHIAZINE/RELATED ANTIPSYCHOTICS
CHLORPROMAZINE	PHENOTHIAZINE/RELATED ANTIPSYCHOTICS
CHLORPROMAZINE	PHENOTHIAZINE/RELATED ANTIPSYCHOTICS
FLUPHENAZINE	PHENOTHIAZINE/RELATED ANTIPSYCHOTICS
FLUPHENAZINE	PHENOTHIAZINE/RELATED ANTIPSYCHOTICS
FLUPHENAZINE	PHENOTHIAZINE/RELATED ANTIPSYCHOTICS
FLUPHENAZINE DECONATE	PHENOTHIAZINE/RELATED ANTIPSYCHOTICS
PERPHENAZINE	PHENOTHIAZINE/RELATED ANTIPSYCHOTICS
THIOTHIXENE	PHENOTHIAZINE/RELATED ANTIPSYCHOTICS
TRIFLUOPERAZINE	PHENOTHIAZINE/RELATED ANTIPSYCHOTICS
ARIPIPRAZOLE	ANTIPSYCHOTICS,OTHER
ARIPIPRAZOLE	ANTIPSYCHOTICS,OTHER
ARIPIPRAZOLE	ANTIPSYCHOTICS,OTHER
CLOZAPINE	ANTIPSYCHOTICS,OTHER
HALOPERIDOL	ANTIPSYCHOTICS,OTHER
HALOPERIDOL	ANTIPSYCHOTICS,OTHER
HALOPERIDOL	ANTIPSYCHOTICS,OTHER
HALOPERIDOL DECANOATE	ANTIPSYCHOTICS,OTHER
LOXAPINE	ANTIPSYCHOTICS,OTHER
LURASIDONE	ANTIPSYCHOTICS,OTHER
MOLINDONE HCL	ANTIPSYCHOTICS,OTHER
OLANZAPINE	ANTIPSYCHOTICS,OTHER
OLANZAPINE	ANTIPSYCHOTICS,OTHER
PALIPERIDONE	ANTIPSYCHOTICS,OTHER
QUETIAPINE FUMARATE	ANTIPSYCHOTICS,OTHER
RISPERIDONE	ANTIPSYCHOTICS,OTHER
RISPERIDONE	ANTIPSYCHOTICS,OTHER
RISPERIDONE	ANTIPSYCHOTICS,OTHER
ZIPRASIDONE	ANTIPSYCHOTICS,OTHER
LITHIUM	LITHIUM SALTS
LITHIUM	LITHIUM SALTS
LITHIUM	LITHIUM SALTS
LITHIUM	LITHIUM SALTS
AMPHETAMINE/DEXTROAMPHETAMINE (EQV-ADDERALL)	AMPHETAMINES
AMPHETAMINE/DEXTROAMPHETAMINE RESIN COMPLEX (EQV-ADDERALL XR)	AMPHETAMINES
DEXTROAMPHETAMINE	AMPHETAMINES
DEXTROAMPHETAMINE	AMPHETAMINES
DEXTROAMPHETAMINE	AMPHETAMINES
DEXTROAMPHETAMINE	AMPHETAMINES
METHYLPHENIDATE	AMPHETAMINE LIKE STIMULANTS
METHYLPHENIDATE	AMPHETAMINE LIKE STIMULANTS
METHYLPHENIDATE	AMPHETAMINE LIKE STIMULANTS
CAFFEINE/SODIUM BENZOATE	CNS STIMULANTS,OTHER
DONEPEZIL (5MG AND 10MG ONLY)	CNS MEDICATIONS,OTHER
ERGOLOID MESYLATES	CNS MEDICATIONS,OTHER
GALANTAMINE	CNS MEDICATIONS,OTHER
GALANTAMINE	CNS MEDICATIONS,OTHER
MEMANTINE HCL	CNS MEDICATIONS,OTHER
PIMOZIDE	CNS MEDICATIONS,OTHER
RILUZOLE	CNS MEDICATIONS,OTHER
DIGOXIN	DIGITALIS GLYCOSIDES
DIGOXIN	DIGITALIS GLYCOSIDES
DIGOXIN	DIGITALIS GLYCOSIDES
ATENOLOL	BETA BLOCKERS/RELATED
BISOPROLOL	BETA BLOCKERS/RELATED
CARVEDILOL	BETA BLOCKERS/RELATED
ESMOLOL HCL	BETA BLOCKERS/RELATED
LABETALOL HCL	BETA BLOCKERS/RELATED
METOPROLOL  TARTRATE	BETA BLOCKERS/RELATED
METOPROLOL  TARTRATE	BETA BLOCKERS/RELATED
METOPROLOL SUCCINATE SUSTAINED ACTION	BETA BLOCKERS/RELATED
PROPRANOLOL HCL	BETA BLOCKERS/RELATED
PROPRANOLOL HCL	BETA BLOCKERS/RELATED
SOTALOL HCL	BETA BLOCKERS/RELATED
ALFUZOSIN	ALPHA BLOCKERS/RELATED
DOXAZOSIN MESYLATE	ALPHA BLOCKERS/RELATED
PRAZOSIN HCL	ALPHA BLOCKERS/RELATED
TAMSULOSIN	ALPHA BLOCKERS/RELATED
TERAZOSIN HCL	ALPHA BLOCKERS/RELATED
AMLODIPINE	CALCIUM CHANNEL BLOCKERS
DILTIAZEM HCL	CALCIUM CHANNEL BLOCKERS
DILTIAZEM HCL	CALCIUM CHANNEL BLOCKERS
DILTIAZEM HCL	CALCIUM CHANNEL BLOCKERS
FELODIPINE	CALCIUM CHANNEL BLOCKERS
NICARDIPINE	CALCIUM CHANNEL BLOCKERS
NIFEDIPINE	CALCIUM CHANNEL BLOCKERS
VERAPAMIL HCL	CALCIUM CHANNEL BLOCKERS
VERAPAMIL HCL	CALCIUM CHANNEL BLOCKERS
VERAPAMIL HCL	CALCIUM CHANNEL BLOCKERS
AMYL NITRITE	ANTIANGINALS
ISOSORBIDE DINITRATE	ANTIANGINALS
ISOSORBIDE DINITRATE	ANTIANGINALS
ISOSORBIDE MONONITRATE	ANTIANGINALS
NITROGLYCERIN	ANTIANGINALS
NITROGLYCERIN	ANTIANGINALS
NITROGLYCERIN	ANTIANGINALS
NITROGLYCERIN	ANTIANGINALS
ADENOSINE	ANTIARRHYTHMICS
AMIODARONE	ANTIARRHYTHMICS
AMIODARONE	ANTIARRHYTHMICS
FLECAINIDE	ANTIARRHYTHMICS
IBUTILIDE	ANTIARRHYTHMICS
PROCAINAMIDE	ANTIARRHYTHMICS
PROPAFENONE	ANTIARRHYTHMICS
QUINIDINE	ANTIARRHYTHMICS
QUINIDINE	ANTIARRHYTHMICS
ATORVASTATIN	ANTILIPEMIC AGENTS
CHOLESTYRAMINE	ANTILIPEMIC AGENTS
COLESTIPOL	ANTILIPEMIC AGENTS
COLESTIPOL	ANTILIPEMIC AGENTS
GEMFIBROZIL	ANTILIPEMIC AGENTS
LOMITAPIDE	ANTILIPEMIC AGENTS
LOVASTATIN	ANTILIPEMIC AGENTS
MIPOMERSEN	ANTILIPEMIC AGENTS
PRAVASTATIN	ANTILIPEMIC AGENTS
SIMVASTATIN	ANTILIPEMIC AGENTS
AMLODIPINE/BENAZEPRIL	ANTIHYPERTENSIVE COMBINATIONS
ATENOLOL/CHLORTHALIDONE	ANTIHYPERTENSIVE COMBINATIONS
HYDROCHLOROTHIAZIDE/LISINOPRIL	ANTIHYPERTENSIVE COMBINATIONS
CLONIDINE	ANTIHYPERTENSIVES,OTHER
CLONIDINE HCL	ANTIHYPERTENSIVES,OTHER
HYDRALAZINE HCL	ANTIHYPERTENSIVES,OTHER
HYDRALAZINE HCL	ANTIHYPERTENSIVES,OTHER
METHYLDOPA	ANTIHYPERTENSIVES,OTHER
METHYLDOPATE HCL	ANTIHYPERTENSIVES,OTHER
MINOXIDIL	ANTIHYPERTENSIVES,OTHER
RESERPINE	ANTIHYPERTENSIVES,OTHER
SODIUM NITROPRUSSIDE	ANTIHYPERTENSIVES,OTHER
ETHANOLAMINE OLEATE	SCLEROSING AGENTS
MORRHUATE	SCLEROSING AGENTS
MORRHUATE SODIUM	SCLEROSING AGENTS
CHLORTHALIDONE	THIAZIDES/RELATED DIURETICS
HYDROCHLOROTHIAZIDE	THIAZIDES/RELATED DIURETICS
HYDROCHLOROTHIAZIDE	THIAZIDES/RELATED DIURETICS
INDAPAMIDE	THIAZIDES/RELATED DIURETICS
METOLAZONE	THIAZIDES/RELATED DIURETICS
BUMETANIDE	LOOP DIURETICS
BUMETANIDE	LOOP DIURETICS
ETHACRYNATE NA	LOOP DIURETICS
ETHACRYNIC ACID	LOOP DIURETICS
FUROSEMIDE	LOOP DIURETICS
FUROSEMIDE	LOOP DIURETICS
FUROSEMIDE	LOOP DIURETICS
ACETAZOLAMIDE	CARBONIC ANHYDRASE INHIBITOR DIURETICS
ACETAZOLAMIDE	CARBONIC ANHYDRASE INHIBITOR DIURETICS
METHAZOLAMIDE	CARBONIC ANHYDRASE INHIBITOR DIURETICS
HYDROCHLOROTHIAZIDE/SPIRONOLACTONE	POTASSIUM SPARING/COMBINATIONS DIURETICS
HYDROCHLOROTHIAZIDE/TRIAMTERENE	POTASSIUM SPARING/COMBINATIONS DIURETICS
HYDROCHLOROTHIAZIDE/TRIAMTERENE	POTASSIUM SPARING/COMBINATIONS DIURETICS
SPIRONOLACTONE	POTASSIUM SPARING/COMBINATIONS DIURETICS
TRIAMTERENE	POTASSIUM SPARING/COMBINATIONS DIURETICS
MANNITOL	DIURETICS,OTHER
BENAZEPRIL	ACE INHIBITORS
CAPTOPRIL	ACE INHIBITORS
ENALAPRIL	ACE INHIBITORS
ENALAPRILAT	ACE INHIBITORS
FOSINOPRIL	ACE INHIBITORS
LISINOPRIL	ACE INHIBITORS
RAMIPRIL	ACE INHIBITORS
LOSARTAN	ANGIOTENSIN II INHIBITOR
VALSARTAN	ANGIOTENSIN II INHIBITOR
INAMRINONE	CARDIOVASCULAR AGENTS,OTHER
MIDODRINE	CARDIOVASCULAR AGENTS,OTHER
MILRINONE	CARDIOVASCULAR AGENTS,OTHER
REGADENOSON	CARDIOVASCULAR AGENTS,OTHER
ALCOHOL ISOPROPYL 70%	ANTIBACTERIAL,TOPICAL
BACITRACIN  (OTC)	ANTIBACTERIAL,TOPICAL
CADEXOMER IODINE	ANTIBACTERIAL,TOPICAL
CHLORHEXIDINE GLUCONATE  (OTC)	ANTIBACTERIAL,TOPICAL
CHLORHEXIDINE GLUCONATE (OTC)	ANTIBACTERIAL,TOPICAL
GENTAMICIN SO4	ANTIBACTERIAL,TOPICAL
HYDROGEN PEROXIDE  (OTC)	ANTIBACTERIAL,TOPICAL
METRONIDAZOLE	ANTIBACTERIAL,TOPICAL
MUPIROCIN	ANTIBACTERIAL,TOPICAL
POVIDONE IODINE	ANTIBACTERIAL,TOPICAL
POVIDONE IODINE  (OTC)	ANTIBACTERIAL,TOPICAL
POVIDONE IODINE (OTC)	ANTIBACTERIAL,TOPICAL
POVIDONE IODINE (OTC)	ANTIBACTERIAL,TOPICAL
SILVER SULFADIAZINE	ANTIBACTERIAL,TOPICAL
SODIUM HYPOCHLORITE  (OTC)	ANTIBACTERIAL,TOPICAL
CASTELLANI PAINT (OTC)	ANTIFUNGAL,TOPICAL
CLOTRIMAZOLE 1%	ANTIFUNGAL,TOPICAL
CLOTRIMAZOLE 1%	ANTIFUNGAL,TOPICAL
CLOTRIMAZOLE 1%	ANTIFUNGAL,TOPICAL
KETOCONAZOLE	ANTIFUNGAL,TOPICAL
KETOCONAZOLE 2%	ANTIFUNGAL,TOPICAL
MICONAZOLE	ANTIFUNGAL,TOPICAL
MICONAZOLE NITRATE 2%	ANTIFUNGAL,TOPICAL
MICONAZOLE NITRATE 2%	ANTIFUNGAL,TOPICAL
NYSTATIN	ANTIFUNGAL,TOPICAL
NYSTATIN  100000UNT/GM	ANTIFUNGAL,TOPICAL
TERBINAFINE HCL 1%	ANTIFUNGAL,TOPICAL
TOLNAFTATE	ANTIFUNGAL,TOPICAL
BACITRACIN 500/POLYMYXIN 10000U/GM  (OTC)	ANTI-INFECTIVE,TOPICAL,OTHER
BACITRACIN 500/POLYMYXIN 10000U/GM  (OTC)	ANTI-INFECTIVE,TOPICAL,OTHER
GENTIAN VIOLET 1%  (OTC)	ANTI-INFECTIVE,TOPICAL,OTHER
GENTIAN VIOLET 2%  (OTC)	ANTI-INFECTIVE,TOPICAL,OTHER
BETAMETHASONE DIPROPIONATE	ANTI-INFLAMMATORY,TOPICAL
BETAMETHASONE DIPROPIONATE	ANTI-INFLAMMATORY,TOPICAL
BETAMETHASONE VALERATE	ANTI-INFLAMMATORY,TOPICAL
BETAMETHASONE VALERATE	ANTI-INFLAMMATORY,TOPICAL
BETAMETHASONE VALERATE	ANTI-INFLAMMATORY,TOPICAL
CLOBETASOL	ANTI-INFLAMMATORY,TOPICAL
CLOBETASOL	ANTI-INFLAMMATORY,TOPICAL
CLOBETASOL	ANTI-INFLAMMATORY,TOPICAL
DESONIDE	ANTI-INFLAMMATORY,TOPICAL
FLUOCINOLONE ACETONIDE 0.01%	ANTI-INFLAMMATORY,TOPICAL
FLUOCINONIDE	ANTI-INFLAMMATORY,TOPICAL
FLUOCINONIDE	ANTI-INFLAMMATORY,TOPICAL
FLUOCINONIDE	ANTI-INFLAMMATORY,TOPICAL
FLURANDRENOLIDE 4MCG/SQCM	ANTI-INFLAMMATORY,TOPICAL
HYDROCORTISONE	ANTI-INFLAMMATORY,TOPICAL
HYDROCORTISONE (PLAIN OR ACETATE)	ANTI-INFLAMMATORY,TOPICAL
HYDROCORTISONE (PLAIN OR ACETATE)	ANTI-INFLAMMATORY,TOPICAL
HYDROCORTISONE (PLAIN OR ACETATE)	ANTI-INFLAMMATORY,TOPICAL
TRIAMCINOLONE	ANTI-INFLAMMATORY,TOPICAL
TRIAMCINOLONE	ANTI-INFLAMMATORY,TOPICAL
SUNSCREEN SPF 30-50/AVOBENZONE/PABA-FREE COMBINATION	SUN PROTECTANTS/SCREENS,TOPICAL
SUNSCREEN SPF 30-50/AVOBENZONE/PABA-FREE COMBINATION	SUN PROTECTANTS/SCREENS,TOPICAL
SUNSCREEN SPF 30-50/AVOBENZONE/PABA-FREE COMBINATION	SUN PROTECTANTS/SCREENS,TOPICAL
SUNSCREEN SPF 30-50/AVOBENZONE/PABA-FREE COMBINATION	SUN PROTECTANTS/SCREENS,TOPICAL
SUNSCREEN SPF 30-50/PHYSICAL BLOCK/PABA-FREE COMBINATION	SUN PROTECTANTS/SCREENS,TOPICAL
SUNSCREEN SPF 30-50/PHYSICAL BLOCK/PABA-FREE COMBINATION (FACIAL)	SUN PROTECTANTS/SCREENS,TOPICAL
AMMONIUM LACTATE	EMOLLIENTS
AMMONIUM LACTATE	EMOLLIENTS
BATH OIL  (OTC)	EMOLLIENTS
HYDROPHILIC	EMOLLIENTS
LANOLIN	EMOLLIENTS
LANOLIN HYDROUS (OTC)	EMOLLIENTS
MINERAL OIL/MINERAL WAX/PETROLATUM/WOOL WAX ALCOHOL (OTC)	EMOLLIENTS
MINERAL OIL/MINERAL WAX/PETROLATUM/WOOL WAX ALCOHOL(OTC)	EMOLLIENTS
MOISTURIZING (OTC)	EMOLLIENTS
PETROLATUM(OTC)	EMOLLIENTS
UREA	EMOLLIENTS
UREA	EMOLLIENTS
POVIDONE IODINE 10% (OTC)	SOAPS/SHAMPOOS/SOAP-FREE CLEANSERS
SELENIUM	SOAPS/SHAMPOOS/SOAP-FREE CLEANSERS
SELENIUM	SOAPS/SHAMPOOS/SOAP-FREE CLEANSERS
ZINC PYRITHIONE 1% (OTC)	SOAPS/SHAMPOOS/SOAP-FREE CLEANSERS
ALUMINUM CHLORIDE (HEXAHYDRATE)	DEODORANTS/ANTIPERSPIRANTS,TOPICAL
LACTIC ACID 16.7%/SAL AC 16.7%/COLLODION (OTC)	KERATOLYTICS/CAUSTICS,TOPICAL
PODOFILOX 0.5%	KERATOLYTICS/CAUSTICS,TOPICAL
SALICYLIC ACID	KERATOLYTICS/CAUSTICS,TOPICAL
SALICYLIC ACID	KERATOLYTICS/CAUSTICS,TOPICAL
SALICYLIC ACID	KERATOLYTICS/CAUSTICS,TOPICAL
SALICYLIC ACID	KERATOLYTICS/CAUSTICS,TOPICAL
SALICYLIC ACID/SULFUR	KERATOLYTICS/CAUSTICS,TOPICAL
SILVER NITRATE	KERATOLYTICS/CAUSTICS,TOPICAL
SULFACETAMIDE NA 10%/SULFUR 5%	KERATOLYTICS/CAUSTICS,TOPICAL
TRICHLOROACETIC ACID 80%	KERATOLYTICS/CAUSTICS,TOPICAL
FLUOROURACIL	ANTINEOPLASTIC,TOPICAL
FLUOROURACIL	ANTINEOPLASTIC,TOPICAL
CAPSAICIN	ANALGESICS,TOPICAL
MENTHOL/METHYL SALICYLATE 10-15% (LOW CONC)	ANALGESICS,TOPICAL
MENTHOL/METHYL SALICYLATE 16-30% (HIGH CONC)	ANALGESICS,TOPICAL
DIBUCAINE 1%   (OTC)	LOCAL ANESTHETICS,TOPICAL
ETHYL CHLORIDE 100%	LOCAL ANESTHETICS,TOPICAL
LIDOCAINE 2.5%/PRILOCAINE 2.5%	LOCAL ANESTHETICS,TOPICAL
LIDOCAINE 5%	LOCAL ANESTHETICS,TOPICAL
LIDOCAINE HCL 2%	LOCAL ANESTHETICS,TOPICAL
LIDOCAINE HCL 4%	LOCAL ANESTHETICS,TOPICAL
LIDOCAINE HCL 5%	LOCAL ANESTHETICS,TOPICAL
PENTAFLUOROPROPANE/TETRAFLUOROETHANE	LOCAL ANESTHETICS,TOPICAL
PRAMOXINE HCL 1%  (OTC)	LOCAL ANESTHETICS,TOPICAL
PRAMOXINE HCL 1%  (OTC)	LOCAL ANESTHETICS,TOPICAL
ISOTRETINOIN ORAL	ANTIACNE AGENTS,SYSTEMIC
BENZOYL PEROXIDE	ANTIACNE AGENTS,TOPICAL
BENZOYL PEROXIDE	ANTIACNE AGENTS,TOPICAL
BENZOYL PEROXIDE 5%/ERYTHROMYCIN 3% TOP GEL	ANTIACNE AGENTS,TOPICAL
CLINDAMYCIN PHOSPHATE	ANTIACNE AGENTS,TOPICAL
CLINDAMYCIN PHOSPHATE	ANTIACNE AGENTS,TOPICAL
ERYTHROMYCIN 2% TOP GEL	ANTIACNE AGENTS,TOPICAL
ERYTHROMYCIN 2% TOP SOLN	ANTIACNE AGENTS,TOPICAL
METRONIDAZOLE	ANTIACNE AGENTS,TOPICAL
TRETINOIN	ANTIACNE AGENTS,TOPICAL
TRETINOIN	ANTIACNE AGENTS,TOPICAL
ACITRETIN	ANTIPSORIATICS,SYSTEMIC
METHOXSALEN	ANTIPSORIATICS,SYSTEMIC
ANTHRALIN	ANTIPSORIATICS,TOPICAL
CALCIPOTRIENE 0.005%	ANTIPSORIATICS,TOPICAL
CALCITRIOL	ANTIPSORIATICS,TOPICAL
COAL TAR	ANTIPSORIATICS,TOPICAL
COAL TAR	ANTIPSORIATICS,TOPICAL
COAL TAR	ANTIPSORIATICS,TOPICAL
COAL TAR	ANTIPSORIATICS,TOPICAL
COAL TAR	ANTIPSORIATICS,TOPICAL
COAL TAR	ANTIPSORIATICS,TOPICAL
COAL TAR	ANTIPSORIATICS,TOPICAL
COAL TAR	ANTIPSORIATICS,TOPICAL
COAL TAR /SALICYLIC ACID	ANTIPSORIATICS,TOPICAL
COAL TAR/SALICYLIC ACID/SULFUR	ANTIPSORIATICS,TOPICAL
ALUMINUM SULFATE/CALCIUM ACETATE  (OTC)	DERMATOLOGICALS,TOPICAL OTHER
BENZOIN COMPOUND 30%/ISOPROPYL ALCOHOL 44.8% SPRAY (OTC)	DERMATOLOGICALS,TOPICAL OTHER
CALAMINE  (OTC)	DERMATOLOGICALS,TOPICAL OTHER
CAMPHOR 0.5%/MENTHOL 0.5%	DERMATOLOGICALS,TOPICAL OTHER
CARRAKLENZ SKIN & WOUND CLEANSER (OTC)	DERMATOLOGICALS,TOPICAL OTHER
CARRINGTON (OTC)	DERMATOLOGICALS,TOPICAL OTHER
CARRINGTON DRESSING  (OTC)	DERMATOLOGICALS,TOPICAL OTHER
COLLAGENASE	DERMATOLOGICALS,TOPICAL OTHER
GLYCOLIC ACID 12%  (OTC)	DERMATOLOGICALS,TOPICAL OTHER
HAMAMELIS WATER 50% (OTC)	DERMATOLOGICALS,TOPICAL OTHER
HYDROQUINONE 4%	DERMATOLOGICALS,TOPICAL OTHER
LUBRICATING (OTC)	DERMATOLOGICALS,TOPICAL OTHER
METHOXSALEN	DERMATOLOGICALS,TOPICAL OTHER
MINERAL OIL,LIGHT (OTC)	DERMATOLOGICALS,TOPICAL OTHER
OATMEAL,COLLOIDAL	DERMATOLOGICALS,TOPICAL OTHER
PERINEAL WASH (OTC)	DERMATOLOGICALS,TOPICAL OTHER
TALC TOP(OTC)	DERMATOLOGICALS,TOPICAL OTHER
ZINC OXIDE (OTC)	DERMATOLOGICALS,TOPICAL OTHER
ZINC OXIDE (OTC)	DERMATOLOGICALS,TOPICAL OTHER
CONTRAST  MEDIA: X-RAY	NON-IONIC CONTRAST MEDIA
INDOCYANINE GREEN	NON-IONIC CONTRAST MEDIA
IOTHALAMATE	IONIC CONTRAST MEDIA
BENZYLPENICILLOYL POLYLYSINE	DIAGNOSTIC ANTIGENS
CANDIDA 1:100 SKIN TEST	DIAGNOSTIC ANTIGENS
COCCIDIODIN 1:100 SKIN TEST	DIAGNOSTIC ANTIGENS
HISTOPLASMIN 1:100 SKIN TEST	DIAGNOSTIC ANTIGENS
MUMPS SKIN TEST (MSTA) ANTIGEN	DIAGNOSTIC ANTIGENS
TUBERBULIN,PURIFIED PROTEIN DERIVATIVE	DIAGNOSTIC ANTIGENS
BLOOD GLUCOSE MONITORING	DIAGNOSTICS,OTHER
BLOOD GLUCOSE MONITORING	DIAGNOSTICS,OTHER
BLOOD GLUCOSE MONITORING	DIAGNOSTICS,OTHER
CONTRAST  MEDIA:  ULTRASOUND	DIAGNOSTICS,OTHER
CONTRAST  MEDIA: MAGNETIC RESONANCE	DIAGNOSTICS,OTHER
COSYNTROPIN INJ	DIAGNOSTICS,OTHER
KETODIASTIX GLUCOSE KETONE TEST STRIP	DIAGNOSTICS,OTHER
METYRAPONE	DIAGNOSTICS,OTHER
NITRAZINE (pH) TEST STRIP	DIAGNOSTICS,OTHER
PROTIRELIN	DIAGNOSTICS,OTHER
SECRETIN (HUMAN)	DIAGNOSTICS,OTHER
URINE GLUCOSE MONITORING DEVICES	DIAGNOSTICS,OTHER
XYLOSE (OTC)	DIAGNOSTICS,OTHER
ALUMINUM HYDROXIDE	ALUMINUM CONTAINING ANTACIDS
ALUMINUM HYDROXIDE	ALUMINUM CONTAINING ANTACIDS
SODIUM BICARBONATE (OTC)	SODIUM BICARBONATE CONTAINING ANTACIDS
ALGINIC AC/NA BICARB/CA STEAR/MG TRI (OTC)	ANTACIDS,OTHER
ALOH/MG CARB/NA ALGINATE (OTC)	ANTACIDS,OTHER
ALOH/MGOH/SIMTH (OTC)	ANTACIDS,OTHER
CALCIUM POLYCARBOPHIL	BULK-FORMING LAXATIVES
CELLULOSE,OXIDIZED	BULK-FORMING LAXATIVES
PSYLLIUM  (OTC)	BULK-FORMING LAXATIVES
PSYLLIUM (SF) (OTC)	BULK-FORMING LAXATIVES
LACTULOSE	HYPEROSMOTIC LAXATIVES
MAGNESIUM CITRATE (OTC)	HYPEROSMOTIC LAXATIVES
MAGNESIUM HYDROXIDE  (OTC)	HYPEROSMOTIC LAXATIVES
POLYETHYLENE GLYCOL 3350 (PEG-3350)	HYPEROSMOTIC LAXATIVES
POLYETHYLENE GLYCOL 3350 (PEG-3350)/ELECTROLYTES	HYPEROSMOTIC LAXATIVES
SODIUM PHOSPHATE (EQV OSMOPREP)	HYPEROSMOTIC LAXATIVES
MINERAL OIL,HEAVY 100%  (OTC)	LUBRICANT LAXATIVES
BISACODYL (OTC)	STIMULANT LAXATIVES
CASTOR OIL	STIMULANT LAXATIVES
DOCUSATE/SENNOSIDES	STIMULANT LAXATIVES
SENNOSIDES (OTC)	STIMULANT LAXATIVES
DOCUSATE (OTC)	STOOL SOFTENER
DOCUSATE (OTC)	CARBON DIOXIDE-RELEASING LAXATIVES
ATROPINE SO4 /DIPHENOXYLATE HCL ORAL	ANTIDIARRHEAL AGENTS
BISMUTH SUBSALICYLATE	ANTIDIARRHEAL AGENTS
BISMUTH SUBSALICYLATE	ANTIDIARRHEAL AGENTS
LACTOBACILLUS  (OTC)	ANTIDIARRHEAL AGENTS
LACTOBACILLUS  (OTC)	ANTIDIARRHEAL AGENTS
LOPERAMIDE HCL	ANTIDIARRHEAL AGENTS
LOPERAMIDE HCL	ANTIDIARRHEAL AGENTS
OCTREOTIDE ACETATE	ANTIDIARRHEAL AGENTS
OCTREOTIDE ACETATE	ANTIDIARRHEAL AGENTS
FAMOTIDINE	HISTAMINE ANTAGONISTS
FAMOTIDINE	HISTAMINE ANTAGONISTS
RANITIDINE	HISTAMINE ANTAGONISTS
RANITIDINE	HISTAMINE ANTAGONISTS
RANITIDINE	HISTAMINE ANTAGONISTS
SUCRALFATE	PROTECTANTS,ULCER
SUCRALFATE	PROTECTANTS,ULCER
MISOPROSTOL	ANTIULCER AGENTS,OTHER
LACTASE (OTC)	DIGESTANTS
PANCREATIC ENZYMES	DIGESTANTS
APREPITANT	ANTIEMETICS
DOXYLAMINE	ANTIEMETICS
ONDANSETRON	ANTIEMETICS
ONDANSETRON	ANTIEMETICS
PROCHLORPERAZINE	ANTIEMETICS
PROCHLORPERAZINE	ANTIEMETICS
PROCHLORPERAZINE MALEATE	ANTIEMETICS
TRIMETHOBENZAMIDE	ANTIEMETICS
BALSALAZIDE DISODIUM	GASTRIC MEDICATIONS,OTHER
MESALAMINE	GASTRIC MEDICATIONS,OTHER
MESALAMINE	GASTRIC MEDICATIONS,OTHER
MESALAMINE	GASTRIC MEDICATIONS,OTHER
OMEPRAZOLE	GASTRIC MEDICATIONS,OTHER
PANTOPRAZOLE	GASTRIC MEDICATIONS,OTHER
PANTOPRAZOLE	GASTRIC MEDICATIONS,OTHER
SIMETHICONE (OTC)	GASTRIC MEDICATIONS,OTHER
SULFASALAZINE	GASTRIC MEDICATIONS,OTHER
SULFASALAZINE	GASTRIC MEDICATIONS,OTHER
URSODIOL	GASTRIC MEDICATIONS,OTHER
URSODIOL	GASTRIC MEDICATIONS,OTHER
PHENAZOPYRIDINE HCL	ANALGESICS,URINARY
OXYBUTYNIN	ANTISPASMODICS,URINARY
OXYBUTYNIN CHLORIDE	ANTISPASMODICS,URINARY
CLINDAMYCIN PHOSPHATE	ANTI-INFECTIVES,VAGINAL
CLOTRIMAZOLE (OTC)	ANTI-INFECTIVES,VAGINAL
METRONIDAZOLE	ANTI-INFECTIVES,VAGINAL
ESTROGENS CONJUGATED	ESTROGENS,VAGINAL
ERGONOVINE MALEATE	OXYTOCICS
DIMETHYLSULFOXIDE	GENITO-URINARY AGENTS,OTHER
LIDOCAINE HCL 3.5%	GENITO-URINARY AGENTS,OTHER
LIDOCAINE HCL URH	GENITO-URINARY AGENTS,OTHER
MOISTURIZER, VAGINAL (EQV-REPLENS)	GENITO-URINARY AGENTS,OTHER
SEVELAMER CARBONATE	GENITO-URINARY AGENTS,OTHER
SILDENAFIL CITRATE	GENITO-URINARY AGENTS,OTHER
HYDROXYPROGESTERONE CAPROATE	#N/A
FISH OIL	HERBS/ALTERNATIVE THERAPIES
DEXAMETHASONE	GLUCOCORTICOIDS
DEXAMETHASONE	GLUCOCORTICOIDS
DEXAMETHASONE	GLUCOCORTICOIDS
DEXAMETHASONE	GLUCOCORTICOIDS
DEXAMETHASONE	GLUCOCORTICOIDS
HYDROCORTISONE	GLUCOCORTICOIDS
HYDROCORTISONE	GLUCOCORTICOIDS
METHYLPREDNISOLONE	GLUCOCORTICOIDS
METHYLPREDNISOLONE	GLUCOCORTICOIDS
METHYLPREDNISOLONE	GLUCOCORTICOIDS
PREDNISONE	GLUCOCORTICOIDS
TRIAMCINOLONE	GLUCOCORTICOIDS
TRIAMCINOLONE (PRESERVATIVE FREE)	GLUCOCORTICOIDS
FLUDROCORTISONE ACETATE	MINERALOCORTICOIDS
DANAZOL	ANDROGENS/ANABOLICS
FLUOXYMESTERONE	ANDROGENS/ANABOLICS
NANDROLONE DECONATE	ANDROGENS/ANABOLICS
TESTOSTERONE	ANDROGENS/ANABOLICS
TESTOSTERONE	ANDROGENS/ANABOLICS
TESTOSTERONE (IN OIL)	ANDROGENS/ANABOLICS
DESOGESTREL0.15MG/ETHINYL ESTRADIOL 30MCG,28 (MONO) (EQV-RECLIPSEN)	CONTRACEPTIVES,SYSTEMIC
ETHINYL ESTRADIOL 0.12MG/ETONOGESTREL 0.015MG (EQV-NUVARING)	CONTRACEPTIVES,SYSTEMIC
ETHINYL ESTRADIOL 20MCG/LEVONORGESTREL 0.1MG,28 (MONO) (EQV-LUTERA)	CONTRACEPTIVES,SYSTEMIC
ETHINYL ESTRADIOL 30MCG/LEVONORGESTREL 0.15MG,28 (MONO) (EQV-LEVLEN)	CONTRACEPTIVES,SYSTEMIC
ETHINYL ESTRADIOL 30MCG/LEVONORGESTREL 0.15MG,91 (MONO) (EQV-SEASONALE)	CONTRACEPTIVES,SYSTEMIC
ETHINYL ESTRADIOL 30MCG/LEVONORGESTREL,28 (TRI) (EQV-TRI-LEVLEN)	CONTRACEPTIVES,SYSTEMIC
ETHINYL ESTRADIOL 35MCG/NORETHINDRONE 1MG,28 (MONO) (EQV-NORINYL 1 +35)	CONTRACEPTIVES,SYSTEMIC
ETHINYL ESTRADIOL 35MCG/NORETHINDRONE,28 (TRI) (EQV-NECON 7/7/7)	CONTRACEPTIVES,SYSTEMIC
ETHINYL ESTRADIOL 35MCG/NORGESTIMATE 0.25MG,28 (MONO) (EQV-MONONESSA)	CONTRACEPTIVES,SYSTEMIC
ETHINYL ESTRADIOL 35MCG/NORGESTIMATE,28 (TRI) (EQV-TRINESSA)	CONTRACEPTIVES,SYSTEMIC
LEVONORGESTREL (EQV. PLAN B and PLAN B ONE STEP)	CONTRACEPTIVES,SYSTEMIC
MESTRANOL 50MCG/NORETHINDRONE 1MG,28 (MONO) (EQV-NORINYL 1+50)	CONTRACEPTIVES,SYSTEMIC
NORETHINDRONE 0.35MG (EQV-NOR QD),28	CONTRACEPTIVES,SYSTEMIC
ESTRADIOL	ESTROGENS
ESTRADIOL	ESTROGENS
ESTRADIOL	ESTROGENS
ESTRADIOL/LEVONORGESTREL (EQV-CLIMARA PRO)	ESTROGENS
ESTROGENS	ESTROGENS
ESTROGENS CONJUGATED	ESTROGENS
ESTROGENS CONJUGATED (EQUINE)	ESTROGENS
ESTROGENS ESTERIFIED	ESTROGENS
ETHINYL ESTRADIOL 20MCG	ESTROGENS
CLOMIPHENE	GONADOTROPINS
INSULIN ASPART	INSULIN
INSULIN ASPART PROTAMINE/INSULIN ASPART (70/30)	INSULIN
INSULIN HUMAN 50/50 (NPH/REG)  (OTC)	INSULIN
INSULIN HUMAN 70/30 (NPH/REG)  (OTC)	INSULIN
INSULIN HUMAN LENTE 100U/ML  (OTC)	INSULIN
INSULIN HUMAN NPH 100U/ML (OTC)	INSULIN
INSULIN HUMAN REGULAR 100U/ML (OTC)	INSULIN
INSULIN LONG ACTING ANALOG	INSULIN
ACARBOSE	ORAL HYPOGLYCEMIC AGENTS,ORAL
GLIPIZIDE	ORAL HYPOGLYCEMIC AGENTS,ORAL
METFORMIN	ORAL HYPOGLYCEMIC AGENTS,ORAL
METFORMIN HCL	ORAL HYPOGLYCEMIC AGENTS,ORAL
SAXAGLIPTIN	ORAL HYPOGLYCEMIC AGENTS,ORAL
DEXTROSE SQUEEZE TUBE (OTC)	ANTIHYPOGLYCEMICS
GLUCAGON	ANTIHYPOGLYCEMICS
GLUCOSE  (OTC)	ANTIHYPOGLYCEMICS
LANREOTIDE	ANTERIOR PITUITARY
DESMOPRESSIN  ACETATE	POSTERIOR PITUITARY
DESMOPRESSIN ACETATE	POSTERIOR PITUITARY
VASOPRESSIN	POSTERIOR PITUITARY
MEDROXYPROGESTERONE ACETATE	PROGESTINS
MEDROXYPROGESTERONE ACETATE	PROGESTINS
MEGESTROL ACETATE	PROGESTINS
MEGESTROL ACETATE	PROGESTINS
LEVOTHYROXINE	THYROID SUPPLEMENTS
LEVOTHYROXINE NA	THYROID SUPPLEMENTS
LIOTHYRONINE	THYROID SUPPLEMENTS
METHIMAZOLE	ANTITHYROID AGENTS
PROPYLTHIOURACIL	ANTITHYROID AGENTS
ALPROSTADIL	PROSTAGLANDINS
ALPROSTADIL URETHRAL	PROSTAGLANDINS
ALENDRONATE	HORMONES/SYNTHETICS/MODIFIERS,OTHER
CALCITONIN	HORMONES/SYNTHETICS/MODIFIERS,OTHER
CALCITONIN	HORMONES/SYNTHETICS/MODIFIERS,OTHER
CONJUGATED ESTROGENS/MEDROXYPROGESTERONE (PREMPRO/PREMPHASE)	HORMONES/SYNTHETICS/MODIFIERS,OTHER
ESTRADIOL/NORETHINDRONE (EQV-COMBIPATCH)	HORMONES/SYNTHETICS/MODIFIERS,OTHER
ETHINYL ESTRADIOL 5MCG/NORETHINDRONE ACETATE 1MG ORAL (FEMHRT)	HORMONES/SYNTHETICS/MODIFIERS,OTHER
ETIDRONATE	HORMONES/SYNTHETICS/MODIFIERS,OTHER
ETIDRONATE	HORMONES/SYNTHETICS/MODIFIERS,OTHER
FINASTERIDE	HORMONES/SYNTHETICS/MODIFIERS,OTHER
GALLIUM	HORMONES/SYNTHETICS/MODIFIERS,OTHER
NONOXYNOL	HORMONES/SYNTHETICS/MODIFIERS,OTHER
PAMIDRONATE	HORMONES/SYNTHETICS/MODIFIERS,OTHER
RISEDRONATE NA	HORMONES/SYNTHETICS/MODIFIERS,OTHER
ZOLEDRONIC	HORMONES/SYNTHETICS/MODIFIERS,OTHER
BCG VACCINE	VACCINES
HAEMOPHILUS B CONJUGATE VACCINE	VACCINES
HEPATITIS A VACCINE	VACCINES
HEPATITIS A/HEPATITIS B VACCINE	VACCINES
HEPATITIS B VACCINE (RECOMBINANT)	VACCINES
INFLUENZA VIRUS VACCINE	VACCINES
MEASLES/MUMPS/RUBELLA VIRUS VACCINE	VACCINES
MENINGOCOCCAL CONJUGATE VACCINE	VACCINES
MENINGOCOCCAL POLYSACCHARIDE VACCINE	VACCINES
PAPILLOMAVIRUS HUMAN	VACCINES
PNEUMOCOCCAL 13-VALENT CONJUGATED VACCINE	VACCINES
PNEUMOCOCCAL POLYSCCHARIDE VACCINE	VACCINES
POLIOVIRUS VACCINE INACTIVATED	VACCINES
RABIES VACCINE	VACCINES
TYPHOID VACCINE	VACCINES
TYPHOID VACCINE LIVE	VACCINES
ZOSTER VACCINE	VACCINES
DIPHTHERIA TOXOID/PERTUSSIS /TETANUS TOXOID	VACCINES/TOXOIDS, OTHER
DIPHTHERIA/TETANUS TOXOID	#N/A
ANTIVENIN,CROTALIDAE POLYVALENT	ANTIVENINS/ANTITOXINS
BOTULISM ANTITOXIN	ANTIVENINS/ANTITOXINS
TETANUS ANTITOXIN	ANTIVENINS/ANTITOXINS
CYTOMEGALOVIRUS IMMUNE GLOBULIN HUMAN	IMMUNOGLOBULINS
GLOBULIN, IMMUNE	IMMUNOGLOBULINS
HEPATITIS B IMMUNE GLOBULIN	IMMUNOGLOBULINS
RABIES IMMUNE GLOBULIN,HUMAN	IMMUNOGLOBULINS
RHO (D) IMMUNE GLOBULIN,HUMAN IM (EQV-RHOGAM)	IMMUNOGLOBULINS
TETANUS IMMUNE GLOBULIN	IMMUNOGLOBULINS
VARICELLA ZOSTER IMMUNE GLOBULIN (HUMAN)	IMMUNOGLOBULINS
CYCLOSPORINE	#N/A
AZATHIOPRINE	IMMUNE SUPPRESSANTS
AZATHIOPRINE	IMMUNE SUPPRESSANTS
BASILIXIMAB	IMMUNE SUPPRESSANTS
CYCLOSPORINE	IMMUNE SUPPRESSANTS
CYCLOSPORINE	IMMUNE SUPPRESSANTS
DACLIZUMAB	IMMUNE SUPPRESSANTS
MUROMONAB-CD3	IMMUNE SUPPRESSANTS
MYCOPHENOLATE MOFETIL	IMMUNE SUPPRESSANTS
MYCOPHENOLATE MOFETIL	IMMUNE SUPPRESSANTS
MYCOPHENOLATE MOFETIL	IMMUNE SUPPRESSANTS
MYCOPHENOLIC ACID	IMMUNE SUPPRESSANTS
SIROLIMUS	IMMUNE SUPPRESSANTS
SIROLIMUS	IMMUNE SUPPRESSANTS
TACROLIMUS	IMMUNE SUPPRESSANTS
TACROLIMUS	IMMUNE SUPPRESSANTS
ALDESLEUKIN	IMMUNE STIMULANTS
DIMETHYL FUMARATE	IMMUNE STIMULANTS
INTERFERON ALFA	IMMUNE STIMULANTS
INTERFERON BETA-1A	IMMUNE STIMULANTS
INTERFERON GAMMA-1B	IMMUNE STIMULANTS
NATALIZUMAB	IMMUNE STIMULANTS
PEGINTERFERON ALFA-2A	IMMUNE STIMULANTS
PEGINTERFERON ALFA-2B	IMMUNE STIMULANTS
ALLERGENIC EXTRACT (VARIOUS)	IMMUNOLOGICAL AGENTS,OTHER
ANTI-THYMOCYTE GLOBULIN	IMMUNOLOGICAL AGENTS,OTHER
ANTI-THYMOCYTE GLOBULIN	IMMUNOLOGICAL AGENTS,OTHER
CROMOLYN SODIUM	IMMUNOLOGICAL AGENTS,OTHER
IMIQUIMOD	IMMUNOLOGICAL AGENTS,OTHER
INTERFERON BETA-1B	IMMUNOLOGICAL AGENTS,OTHER
LENALIDOMIDE	IMMUNOLOGICAL AGENTS,OTHER
THALIDOMIDE	IMMUNOLOGICAL AGENTS,OTHER
TRICHOPHYTON	IMMUNOLOGICAL AGENTS,OTHER
ACETIC ACID	IRRIGATION SOLUTIONS
CITRIC ACID/GLUCONO-DELTA/LACTONE/MAGNESIUM CARBONATE	IRRIGATION SOLUTIONS
CITRIC ACID/MAGNESIUM OXIDE/SODIUM CARBONATE	IRRIGATION SOLUTIONS
GLYCINE	IRRIGATION SOLUTIONS
LACTATED RINGERS	IRRIGATION SOLUTIONS
NEO /POLYMYX	IRRIGATION SOLUTIONS
RINGER'S	IRRIGATION SOLUTIONS
SODIUM CHLORIDE	IRRIGATION SOLUTIONS
WATER	IRRIGATION SOLUTIONS
DEXTROSE/PERITONEAL DIALYSIS	PERITONEAL DIALYSIS SOLUTIONS
SALSALATE	SALICYLATES,ANTIRHEUMATIC
DICLOFENAC NA	NONSALICYLATE NSAIs,ANTIRHEUMATIC
ETODOLAC	NONSALICYLATE NSAIs,ANTIRHEUMATIC
IBUPROFEN	NONSALICYLATE NSAIs,ANTIRHEUMATIC
IBUPROFEN	NONSALICYLATE NSAIs,ANTIRHEUMATIC
INDOMETHACIN	NONSALICYLATE NSAIs,ANTIRHEUMATIC
INDOMETHACIN	NONSALICYLATE NSAIs,ANTIRHEUMATIC
KETOROLAC TROMETHAMINE	NONSALICYLATE NSAIs,ANTIRHEUMATIC
MELOXICAM	NONSALICYLATE NSAIs,ANTIRHEUMATIC
NAPROXEN	NONSALICYLATE NSAIs,ANTIRHEUMATIC
SULINDAC	NONSALICYLATE NSAIs,ANTIRHEUMATIC
PENICILLAMINE	PENICILLAMINE
AURANOFIN	GOLD COMPOUNDS,ANTIRHEUMATIC
AUROTHIOGLUCOSE	GOLD COMPOUNDS,ANTIRHEUMATIC
GOLD NA THIOMALATE	GOLD COMPOUNDS,ANTIRHEUMATIC
LEFLUNOMIDE	ANTIRHEUMATICS,OTHER
BACLOFEN	SKELETAL MUSCLE RELAXANTS
BACLOFEN	SKELETAL MUSCLE RELAXANTS
CYCLOBENZAPRINE	SKELETAL MUSCLE RELAXANTS
DANTROLENE	SKELETAL MUSCLE RELAXANTS
DANTROLENE (i.e. Ryanodex)	SKELETAL MUSCLE RELAXANTS
METHOCARBAMOL	SKELETAL MUSCLE RELAXANTS
TIZANIDINE	SKELETAL MUSCLE RELAXANTS
ATRACURIUM	NEUROMUSCULAR BLOCKING AGENTS
CISATRACURIUM	NEUROMUSCULAR BLOCKING AGENTS
PANCURONIUM BROMIDE	NEUROMUSCULAR BLOCKING AGENTS
ROCURONIUM BROMIDE	NEUROMUSCULAR BLOCKING AGENTS
SUCCINYLCHOLINE	NEUROMUSCULAR BLOCKING AGENTS
VECURONIUM	NEUROMUSCULAR BLOCKING AGENTS
ALLOPURINOL	ANTIGOUT AGENTS
COLCHICINE	ANTIGOUT AGENTS
COLCHICINE	ANTIGOUT AGENTS
PROBENECID	ANTIGOUT AGENTS
GLATIRAMER ACETATE	MUSCULOSKELETAL AGENTS,OTHER
OXYMETAZOLINE HCL  (OTC)	DECONGESTANTS,NASAL
PHENYLEPHRINE HCL (OTC)	DECONGESTANTS,NASAL
FLUNISOLIDE	ANTI-INFLAMMATORIES,NASAL
FLUTICASONE (PROPRIONATE ONLY)	ANTI-INFLAMMATORIES,NASAL
BENZOCAINE (OTC)	ANESTHETICS,MUCOSAL
COCAINE HCL	ANESTHETICS,MUCOSAL
LIDOCAINE HCL 2% VISCOUS	ANESTHETICS,MUCOSAL
PHENOL	ANESTHETICS,MUCOSAL
THROAT LOZENGE	ANESTHETICS,MUCOSAL
CLOTRIMAZOLE	NASAL AND THROAT,TOPICAL,OTHER
CROMOLYN SODIUM	NASAL AND THROAT,TOPICAL,OTHER
IPRATROPIUM BROMIDE	NASAL AND THROAT,TOPICAL,OTHER
SODIUM CHLORIDE (OTC)	NASAL AND THROAT,TOPICAL,OTHER
BETAXOLOL	BETA-BLOCKERS,TOPICAL OPHTHALMIC
BETAXOLOL	BETA-BLOCKERS,TOPICAL OPHTHALMIC
LEVOBUNOLOL OPH	BETA-BLOCKERS,TOPICAL OPHTHALMIC
TIMOLOL	BETA-BLOCKERS,TOPICAL OPHTHALMIC
TIMOLOL	BETA-BLOCKERS,TOPICAL OPHTHALMIC
ACETYLCHOLINE CHLORIDE	MIOTICS,TOPICAL OPHTHALMIC
CARBACHOL	MIOTICS,TOPICAL OPHTHALMIC
ECHOTHIOPHATE IODIDE	MIOTICS,TOPICAL OPHTHALMIC
PILOCARPINE	MIOTICS,TOPICAL OPHTHALMIC
PILOCARPINE	MIOTICS,TOPICAL OPHTHALMIC
DIPIVEFRIN HCL	ADRENERGICS,TOPICAL OPHTHALMIC
BRIMONIDINE/BRINZOLAMIDE	ANTIGLAUCOMA COMBINATIONS,TOPICAL OPHTHALMIC
DORZOLAMIDE/TIMOLOL	ANTIGLAUCOMA COMBINATIONS,TOPICAL OPHTHALMIC
BRIMONIDINE TARTRATE	ANTIGLAUCOMA,OTHER
DORZOLAMIDE HCL	ANTIGLAUCOMA,OTHER
LATANOPROST	ANTIGLAUCOMA,OTHER
MITOMYCIN	ANTIGLAUCOMA,OTHER
CHLORAMPHENICOL	ANTIBACTERIALS,TOPICAL OPHTHALMIC
CIPROFLOXACIN HCL	ANTIBACTERIALS,TOPICAL OPHTHALMIC
ERYTHROMYCIN	ANTIBACTERIALS,TOPICAL OPHTHALMIC
GENTAMICIN SO4	ANTIBACTERIALS,TOPICAL OPHTHALMIC
GENTAMICIN SO4 	ANTIBACTERIALS,TOPICAL OPHTHALMIC
MOXIFLOXACIN	ANTIBACTERIALS,TOPICAL OPHTHALMIC
OFLOXACIN	ANTIBACTERIALS,TOPICAL OPHTHALMIC
SULFACETAMIDE NA	ANTIBACTERIALS,TOPICAL OPHTHALMIC
SULFACETAMIDE NA	ANTIBACTERIALS,TOPICAL OPHTHALMIC
TOBRAMYCIN	ANTIBACTERIALS,TOPICAL OPHTHALMIC
BACITRACIN/NEOMYCIN/POLYMYXIN	ANTI-INFECTIVE,TOPICAL OPHTHALMIC,OTHER
BACITRACIN/POLYMYXIN	ANTI-INFECTIVE,TOPICAL OPHTHALMIC,OTHER
GRAMICIDIN/NEOMYCIN/POLYMYXIN	ANTI-INFECTIVE,TOPICAL OPHTHALMIC,OTHER
POLYMYXIN/TRIMETHOPRIM	ANTI-INFECTIVE,TOPICAL OPHTHALMIC,OTHER
NATAMYCIN	ANTIFUNGALS,TOPICAL OPHTHALMIC
GANCICLOVIR	ANTIVIRALS,TOPICAL OPHTHALMIC
GANCICLOVIR	ANTIVIRALS,TOPICAL OPHTHALMIC
TRIFLURIDINE	ANTIVIRALS,TOPICAL OPHTHALMIC
VIDARABINE	ANTIVIRALS,TOPICAL OPHTHALMIC
CYCLOSPORINE	ANTI-INFLAMMATORIES,TOPICAL OPHTHALMIC
DEXAMETHASONE NA PHOSPHATE	ANTI-INFLAMMATORIES,TOPICAL OPHTHALMIC
DICLOFENAC NA	ANTI-INFLAMMATORIES,TOPICAL OPHTHALMIC
FLUOROMETHOLONE	ANTI-INFLAMMATORIES,TOPICAL OPHTHALMIC
FLUOROMETHOLONE	ANTI-INFLAMMATORIES,TOPICAL OPHTHALMIC
KETOROLAC TROMETHAMINE	ANTI-INFLAMMATORIES,TOPICAL OPHTHALMIC
PREDNISOLONE	ANTI-INFLAMMATORIES,TOPICAL OPHTHALMIC
RIMEXOLONE OPH	ANTI-INFLAMMATORIES,TOPICAL OPHTHALMIC
BACITRACIN/HC /NEO/POLYMYX	ANTI-INFECTIVE/ANTI-INFLAMMATORY COMBINATIONS,TOPICAL OPHTHALMIC
DEXAMETHASONE NA PHOS/NEOMYCIN	ANTI-INFECTIVE/ANTI-INFLAMMATORY COMBINATIONS,TOPICAL OPHTHALMIC
DEXAMETHASONE/NEO/POLYMX	ANTI-INFECTIVE/ANTI-INFLAMMATORY COMBINATIONS,TOPICAL OPHTHALMIC
DEXAMETHASONE/TOBRAMYCIN	ANTI-INFECTIVE/ANTI-INFLAMMATORY COMBINATIONS,TOPICAL OPHTHALMIC
DEXAMETHASONE/TOBRAMYCIN	ANTI-INFECTIVE/ANTI-INFLAMMATORY COMBINATIONS,TOPICAL OPHTHALMIC
GENTAMICIN/PREDNISOLONE	ANTI-INFECTIVE/ANTI-INFLAMMATORY COMBINATIONS,TOPICAL OPHTHALMIC
PREDNISOLONE NA PHOSPHATE/SULFACETAMIDE	ANTI-INFECTIVE/ANTI-INFLAMMATORY COMBINATIONS,TOPICAL OPHTHALMIC
CONTACT LENS SOLUTION	CONTACT LENS SOLUTIONS
POVIDONE IODINE	CONTACT LENS SOLUTIONS
ARTIFICIAL TEARS METHYLCELLULOSE (OTC)	EYE WASHES/LUBRICANTS
ARTIFICIAL TEARS POLYVINYL ALCOHOL (PF) (OTC)	EYE WASHES/LUBRICANTS
ARTIFICIAL TEARS SOLN (OTC)	EYE WASHES/LUBRICANTS
CARBOXYMETHYLCELLULOSE SODIUM	EYE WASHES/LUBRICANTS
EYE RINSE  (OTC)	EYE WASHES/LUBRICANTS
HIGH VISCOSITY ARTIFICIAL TEARS (OTC)	EYE WASHES/LUBRICANTS
IRRIGATING EYE	EYE WASHES/LUBRICANTS
LUBRICATING (PF) (OTC)	EYE WASHES/LUBRICANTS
OPHTH LUBRICATING OINTMENT (PF) (OTC)	EYE WASHES/LUBRICANTS
ATROPINE SULFATE	MYDRIATICS/CYCLOPLEGICS,TOPICAL OPHTHALMIC
ATROPINE SULFATE	MYDRIATICS/CYCLOPLEGICS,TOPICAL OPHTHALMIC
CYCLOPENTOLATE HCL	MYDRIATICS/CYCLOPLEGICS,TOPICAL OPHTHALMIC
CYCLOPENTOLATE/PHENYLEPHRINE	MYDRIATICS/CYCLOPLEGICS,TOPICAL OPHTHALMIC
DEXTRAN 70/HYPROMELLOSE (EQV OCUCOAT)	MYDRIATICS/CYCLOPLEGICS,TOPICAL OPHTHALMIC
HOMATROPINE HYDROBROMIDE	MYDRIATICS/CYCLOPLEGICS,TOPICAL OPHTHALMIC
PHENYLEPHRINE HCL	MYDRIATICS/CYCLOPLEGICS,TOPICAL OPHTHALMIC
SCOPOLAMINE HBR	MYDRIATICS/CYCLOPLEGICS,TOPICAL OPHTHALMIC
TROPICAMIDE	MYDRIATICS/CYCLOPLEGICS,TOPICAL OPHTHALMIC
PROPARACAINE	ANESTHETICS,TOPICAL OPHTHALMIC
TETRACAINE HCL	ANESTHETICS,TOPICAL OPHTHALMIC
NAPHAZOLINE	DECONGESTANTS,TOPICAL OPHTHALMIC
AFLIBERCEPT	OPHTHALMICS,OTHER
APRACLONIDINE HCL	OPHTHALMICS,OTHER
BENOXINATE HCL/FLUORESCEIN NA	OPHTHALMICS,OTHER
BENZALKONIUM CHLORIDE/TYLOXAPOL OPH SOLN (OTC)	OPHTHALMICS,OTHER
CHONDROITIN/HYALURONATE	OPHTHALMICS,OTHER
CHONDROITIN/HYALURONATE	OPHTHALMICS,OTHER
CROMOLYN NA OPH SOLN	OPHTHALMICS,OTHER
FLUORESCEIN	OPHTHALMICS,OTHER
FLUORESCEIN	OPHTHALMICS,OTHER
FLUORESCEIN	OPHTHALMICS,OTHER
FLUORESCEIN NA /PROPARACAINE	OPHTHALMICS,OTHER
FLURBIPROFEN NA	OPHTHALMICS,OTHER
FOSCARNET NA	OPHTHALMICS,OTHER
GELATIN,ABSORBABLE	OPHTHALMICS,OTHER
HYALURONATE NA	OPHTHALMICS,OTHER
KETOTIFEN	OPHTHALMICS,OTHER
LODOXAMIDE TROMETHAMINE	OPHTHALMICS,OTHER
NAPHAZOLINE/PHENIRAMINE	OPHTHALMICS,OTHER
RANIBIZUMAB	OPHTHALMICS,OTHER
ROSE BENGAL (OTC)	OPHTHALMICS,OTHER
SODIUM CHLORIDE (OTC)	OPHTHALMICS,OTHER
SODIUM CHLORIDE (OTC)	OPHTHALMICS,OTHER
TRYPAN BLUE	OPHTHALMICS,OTHER
SODIUM FLUORIDE (1.1%)	CARIOSTATICS,TOPICAL
SODIUM FLUORIDE (1.1%)	CARIOSTATICS,TOPICAL
SODIUM FLUORIDE (5%)	CARIOSTATICS,TOPICAL
ORABASE PLAIN PASTE (OTC)	DENTAL PROTECTANTS
ARTIFICIAL SALIVA  (OTC)	MOUTHWASHES
CHLORHEXIDINE GLUCONATE	MOUTHWASHES
MINOCYCLINE	DENTAL AND ORAL AGENTS,TOPICAL,OTHER
TRIAMCINOLONE ACETONIDE DENTAL	DENTAL AND ORAL AGENTS,TOPICAL,OTHER
ACETIC ACID/ALUMINUM ACETATE	ANTI-INFECTIVES,TOPICAL OTIC OTHER
CIPROFLOXACIN/DEXAMETHASONE	ANTI-INFECTIVE/ANTI-INFLAMMATORY COMBINATIONS,TOPICAL OTIC
HC/NEOMYCIN/POLYMYXIN OTIC	ANTI-INFECTIVE/ANTI-INFLAMMATORY COMBINATIONS,TOPICAL OTIC
CARBAMIDE PEROXIDE/GLYCERIN (OTC)	CERUMINOLYTICS
DEXTROSE 25%	PHARMACEUTICAL AIDS/REAGENTS
PHENOL	PHARMACEUTICAL AIDS/REAGENTS
PROPYLENE GLYCOL	PHARMACEUTICAL AIDS/REAGENTS
SODIUM CITRATE	PHARMACEUTICAL AIDS/REAGENTS
SODIUM CITRATE	PHARMACEUTICAL AIDS/REAGENTS
SORBITOL 70%	PHARMACEUTICAL AIDS/REAGENTS
WATER	PHARMACEUTICAL AIDS/REAGENTS
FLUNISOLIDE	ANTI-INFLAMMATORIES,INHALATION
MOMETASONE FUROATE	ANTI-INFLAMMATORIES,INHALATION
ALBUTEROL	BRONCHODILATORS,SYMPATHOMIMETIC,INHALATION
ALBUTEROL	BRONCHODILATORS,SYMPATHOMIMETIC,INHALATION
FORMOTEROL	BRONCHODILATORS,SYMPATHOMIMETIC,INHALATION
METAPROTERENOL	BRONCHODILATORS,SYMPATHOMIMETIC,INHALATION
OLODATEROL	BRONCHODILATORS,SYMPATHOMIMETIC,INHALATION
ALBUTEROL	BRONCHODILATORS,SYMPATHOMIMETIC,ORAL
TERBUTALINE SULFATE	BRONCHODILATORS,SYMPATHOMIMETIC,ORAL
AMINOPHYLLINE DIHYDRATE	BRONCHODILATORS,XANTHINE-DERIVATIVE
THEOPHYLLINE	BRONCHODILATORS,XANTHINE-DERIVATIVE
THEOPHYLLINE	BRONCHODILATORS,XANTHINE-DERIVATIVE
THEOPHYLLINE	BRONCHODILATORS,XANTHINE-DERIVATIVE
THEOPHYLLINE	BRONCHODILATORS,XANTHINE-DERIVATIVE
THEOPHYLLINE	BRONCHODILATORS,XANTHINE-DERIVATIVE
THEOPHYLLINE	BRONCHODILATORS,XANTHINE-DERIVATIVE
THEOPHYLLINE	BRONCHODILATORS,XANTHINE-DERIVATIVE
IPRATROPIUM BROMIDE	BRONCHODILATORS,ANTICHOLINERGIC
IPRATROPIUM BROMIDE	BRONCHODILATORS,ANTICHOLINERGIC
TIOTROPIUM	BRONCHODILATORS,ANTICHOLINERGIC
ALBUTEROL/IPRATROPIUM	ANTIASTHMA,OTHER
ALBUTEROL/IPRATROPIUM	ANTIASTHMA,OTHER
BUDESONIDE/FORMOTEROL FUMARATE	ANTIASTHMA,OTHER
CROMOLYN SODIUM	ANTIASTHMA,OTHER
MONTELUKAST	ANTIASTHMA,OTHER
PSEUDOEPHEDRINE HCL  (OTC)	DECONGESTANTS,SYSTEMIC
CODEINE/GUAIFENESIN	OPIOID-CONTAINING ANTITUSSIVES/EXPECTORANTS
BENZONATATE	NON-OPIOID-CONTAINING ANTITUSSIVES/EXPECTORANTS
DEXTROMETHORPHAN/GUAIFENESIN  (OTC)	NON-OPIOID-CONTAINING ANTITUSSIVES/EXPECTORANTS
DEXTROMETHORPHAN/GUAIFENESIN (SF)  (OTC)	NON-OPIOID-CONTAINING ANTITUSSIVES/EXPECTORANTS
GUAIFENESIN	NON-OPIOID-CONTAINING ANTITUSSIVES/EXPECTORANTS
GUAIFENESIN	NON-OPIOID-CONTAINING ANTITUSSIVES/EXPECTORANTS
GUAIFENESIN 	NON-OPIOID-CONTAINING ANTITUSSIVES/EXPECTORANTS
POTASSIUM IODIDE	NON-OPIOID-CONTAINING ANTITUSSIVES/EXPECTORANTS
ACETYLCYSTEINE	MUCOLYTICS
PSEUDOEPHEDRINE/TRIPROLIDINE	ANTIHISTAMINE/DECONGESTANT
PSEUDOEPHEDRINE/TRIPROLIDINE	ANTIHISTAMINE/DECONGESTANT
AMMONIA,AROMATIC	RESPIRATORY AGENTS,OTHER
DOXAPRAM HCL	RESPIRATORY AGENTS,OTHER
SODIUM CHLORIDE  (OTC)	RESPIRATORY AGENTS,OTHER
WATER	RESPIRATORY AGENTS,OTHER
HYDROCORTISONE	ANTI-INFLAMMATORIES,RECTAL
HYDROCORTISONE	ANTI-INFLAMMATORIES,RECTAL
MESALAMINE	ANTI-INFLAMMATORIES,RECTAL
HEMORRHOIDAL (OTC)	HEMORRHOIDAL PREPARATIONS WITHOUT STEROID
HEMORRHOIDAL (OTC)	HEMORRHOIDAL PREPARATIONS WITHOUT STEROID
HYDROCORTISONE	HEMORRHOIDAL PREPARATIONS WITH STEROID
HYDROCORTISONE	HEMORRHOIDAL PREPARATIONS WITH STEROID
HYDROCORTISONE/PRAMOXINE	HEMORRHOIDAL PREPARATIONS WITH STEROID
HYDROCORTISONE/PRAMOXINE	HEMORRHOIDAL PREPARATIONS WITH STEROID
BISACODYL	LAXATIVES,RECTAL
BISACODYL (OTC)	LAXATIVES,RECTAL
DOCUSATE (OTC)	LAXATIVES,RECTAL
GLYCERIN (ADULT)  (OTC)	LAXATIVES,RECTAL
MINERAL OIL (OTC)	LAXATIVES,RECTAL
SODIUM BIPHOSPHATE/SODIUM PHOSPHATE   (OTC)	LAXATIVES,RECTAL
ALCOHOL/DEXTROSE	IV SOLUTIONS WITHOUT ELECTROLYTES
DEXTROSE	IV SOLUTIONS WITHOUT ELECTROLYTES
DEXTROSE/ISOLYTE	IV SOLUTIONS WITH ELECTROLYTES
DEXTROSE/KCL	IV SOLUTIONS WITH ELECTROLYTES
DEXTROSE/LACTATED RINGERS	IV SOLUTIONS WITH ELECTROLYTES
DEXTROSE/SODIUM CHLORIDE	IV SOLUTIONS WITH ELECTROLYTES
DEXTROSE/SODIUM CHLORIDE/KCL	IV SOLUTIONS WITH ELECTROLYTES
LACTATED RINGER'S	IV SOLUTIONS WITH ELECTROLYTES
POTASSIUM CHLORIDE INJ	IV SOLUTIONS WITH ELECTROLYTES
RINGER'S	IV SOLUTIONS WITH ELECTROLYTES
SODIUM CHLORIDE	IV SOLUTIONS WITH ELECTROLYTES
SODIUM LACTATE	IV SOLUTIONS WITH ELECTROLYTES
NUTRITION SUPL BOOST PLUS VANILLA (OTC)	ENTERAL NUTRITION
NUTRITION SUPL ENSURE/VANILLA (OTC)	ENTERAL NUTRITION
NUTRITION SUPL JEVITY (1.2 CAL, 1.5 CAL)	ENTERAL NUTRITION
NUTRITION SUPL OSMOLITE (1.2 CAL, 1.5 CAL)	ENTERAL NUTRITION
THICKENING AGENT GUM BASED	ENTERAL NUTRITION
THICKENING AGENT STARCH BASED	ENTERAL NUTRITION
FAT EMULSION	LIPID SUPPLEMENTS
FERRIC NA GLUCONATE	IRON
FERROUS GLUCONATE	IRON
FERROUS SULFATE  (OTC)	IRON
FERROUS SULFATE (OTC)	IRON
IRON DEXTRAN COMPLEX (LOW MOLECULAR WEIGHT) (EQV INFED)	IRON
IRON SUCROSE	IRON
CALCIUM ACETATE	CALCIUM
CALCIUM CARBONATE (OTC)	CALCIUM
CALCIUM CARBONATE (OTC)	CALCIUM
CALCIUM CHLORIDE	CALCIUM
CALCIUM CITRATE	CALCIUM
CALCIUM GLUCONATE	CALCIUM
POTASSIUM	POTASSIUM
POTASSIUM ACETATE	POTASSIUM
POTASSIUM BICARBONATE	POTASSIUM
POTASSIUM CHLORIDE	POTASSIUM
POTASSIUM CHLORIDE	POTASSIUM
POTASSIUM CHLORIDE	POTASSIUM
SODIUM ACETATE	SODIUM
SODIUM CITRATE	SODIUM
ZINC CHLORIDE	ZINC
ZINC SULFATE	ZINC
ZINC SULFATE	ZINC
MAGNESIUM OXIDE  (OTC)	MAGNESIUM
MAGNESIUM SULFATE	MAGNESIUM
K PHOSPHATE /NA BIPHOSPHATE/NA PHOSPHATE	PHOSPHORUS
PHOSPHORUS/K/NA  (OTC)	PHOSPHORUS
PHOSPHORUS/POTASSIUM	PHOSPHORUS
PHOSPHORUS/POTASSIUM	PHOSPHORUS
PHOSPHORUS/SODIUM	PHOSPHORUS
SODIUM BICARBONATE	BICARBONATES
CITRIC ACID/K CITRATE/NA CITRATE	CITRATES
CITRIC ACID/NA CITRATE	CITRATES
CITRIC ACID/POTASSIUM CITRATE	CITRATES
CITRIC ACID/POTASSIUM CITRATE	CITRATES
POTASSIUM CITRATE	CITRATES
LANTHANUM CARBONATE	ELECTROLYTES/MINERALS,COMBINATIONS
TPN ELECTROLYTE	ELECTROLYTES/MINERALS,COMBINATIONS
TRACE ELEMENTS	ELECTROLYTES/MINERALS,COMBINATIONS
AMMONIUM CHLORIDE	ELECTROLYTES/MINERALS,OTHER
CHROMIUM	ELECTROLYTES/MINERALS,OTHER
COPPER INJ	ELECTROLYTES/MINERALS,OTHER
SELENIUM	ELECTROLYTES/MINERALS,OTHER
AMINO ACIDS	AMINO ACIDS/PROTEINS,PARENTERAL,WITHOUT ADDED ELECTROLYTES
AMINO ACIDS/DEXTROSE	AMINO ACIDS/PROTEINS,PARENTERAL,WITHOUT ADDED ELECTROLYTES
ALCOHOL, ABSOLUTE	THERAPEUTIC NUTRIENTS/MINERALS/ELECTROLYES,OTHER
TROMETHAMINE	THERAPEUTIC NUTRIENTS/MINERALS/ELECTROLYES,OTHER
VITAMIN A  (OTC)	VITAMIN A
CYANOCOBALAMIN	CYANOCOBALAMIN
CYANOCOBALAMIN	CYANOCOBALAMIN
FOLIC ACID	FOLIC ACID/LEUCOVORIN
FOLIC ACID	FOLIC ACID/LEUCOVORIN
LEUCOVORIN CALCIUM	FOLIC ACID/LEUCOVORIN
LEUCOVORIN CALCIUM	FOLIC ACID/LEUCOVORIN
NIACIN	NICOTINIC ACID
NIACIN	NICOTINIC ACID
NIACIN	NICOTINIC ACID
NIACINAMIDE	NICOTINIC ACID
PYRIDOXINE HCL	PYRIDOXINE
PYRIDOXINE HCL (OTC)	PYRIDOXINE
THIAMINE	THIAMINE
THIAMINE HCL (OTC)	THIAMINE
VITAMIN B COMPLEX  (OTC)	VITAMIN B,OTHER
ASCORBIC ACID INJ	VITAMIN C
ASCORBIC ACID ORAL (OTC)	VITAMIN C
CALCITRIOL	CALCITRIOL
CALCITRIOL	CALCITRIOL
DIHYDROTACHYSTEROL	DIHYDROTACHYSTEROL
DIHYDROTACHYSTEROL	DIHYDROTACHYSTEROL
DIHYDROTACHYSTEROL	DIHYDROTACHYSTEROL
VITAMIN D (CHOLECALCIFEROL OR ERGOCALCIFEROL 400 Unit to 2000 Unit)	ERGOCALCIFEROL
VITAMIN D, HIGH DOSE (CHOLECALCIFEROL OR ERGOCALCIFEROL 50,000 Unit)	ERGOCALCIFEROL
VITAMIN E	VITAMIN E
PHYTONADIONE	PHYTONADIONE
PHYTONADIONE	PHYTONADIONE
MULTIVITAMIN	MULTIVITAMINS
MULTIVITAMIN OPHTHALMIC (NO BETA CAROTENE)	MULTIVITAMINS
MULTIVITAMIN RENAL WITH < OR = 1MG FOLIC ACID	MULTIVITAMINS
MULTIVITAMINS (OTC)	MULTIVITAMINS
CALCIUM/VITAMIN D  (OTC)	MULTIVITAMINS WITH MINERALS
MULTIVITAMIN/MINERALS  (OTC)	MULTIVITAMINS WITH MINERALS
MULTIVITAMIN/MINERALS  (OTC)	MULTIVITAMINS WITH MINERALS
MULTIVITAMIN/MINERALS NO IRON  (OTC)	MULTIVITAMINS WITH MINERALS
MULTIVITAMIN/MINERALS SENIOR  (OTC)	MULTIVITAMINS WITH MINERALS
MULTIVITAMIN/MINERALS PRENATAL	#N/A
EYE PAD STERILE	PADS,GAUZE,STERILE
GAUZE PAD STERILE	PADS,GAUZE,STERILE
KERLIX SUPER SPONGE MEDIUM STERILE	PADS,GAUZE,STERILE
PAD ABDOMINAL STERILE	PADS,GAUZE,STERILE
GAUZE PAD NONSTERILE	PADS,GAUZE,NON-STERILE
PAD ABDOMINAL NONSTERILE	PADS,GAUZE,NON-STERILE
DRESSING NON-ADHESIVE OIL/EMULSION	PADS,NON-ADHERING
GAUZE NON-ADHESIVE PETROLATUM	PADS,NON-ADHERING
PAD NON-ADHESIVE STERILE	PADS,NON-ADHERING
PADS,NON-ADHERING	PADS,NON-ADHERING
BANDAGE,ADHESIVE (1IN X 3IN) (PLASTIC, FABRIC)	PADS,GAUZE WITH ADHESIVE
BANDAGE,ADHESIVE FLEXIBLE FABRIC 2IN X 3-1/2IN	PADS,GAUZE WITH ADHESIVE
PAD W/ADHESIVE STERILE	PADS,GAUZE WITH ADHESIVE
PAD ALCOHOL PREP	PADS,GAUZE WITH MEDICATION ADDED
PAD ANTISEPTIC	PADS,GAUZE WITH MEDICATION ADDED
GAUZE FINE MESH STERILE	GAUZE,FINE MESH
TRANSPARENT DRESSING	BANDAGE,FILM
BANDAGE ELASTIC	BANDAGE,ELASTIC
BANDAGE ELASTIC ADHESIVE	BANDAGE,ELASTIC
BANDAGE TUBULAR ELASTIC	BANDAGE,STRETCH
GAUZE  ELASTIC STERILE	BANDAGE,STRETCH
GAUZE ELASTIC NONSTERILE	BANDAGE,STRETCH
KERLIX 4.5IN STERILE	BANDAGE,STRETCH
PAD,FOAM SELF-ADHERE	FOAM WITH ADHESIVE
GAUZE PACKING PLAIN	PACKING,GAUZE,PLAIN
GAUZE PACKING MEDICATED	PACKING,GAUZE,MEDICATED
DRESSING ALGINATE	BANDAGES/DRESSINGS,OTHER
DRESSING HYDROCOLLOID	BANDAGES/DRESSINGS,OTHER
DRESSING HYDROGEL	BANDAGES/DRESSINGS,OTHER
DRESSING TRAYS	BANDAGES/DRESSINGS,OTHER
DRESSING,PROFORE-LF 4-LAYER SN#66020626	BANDAGES/DRESSINGS,OTHER
SOCK, STUMP	BANDAGES/DRESSINGS,OTHER
STERI-STRIPS	BANDAGES/DRESSINGS,OTHER
TRACHEOSTOMY PAD	BANDAGES/DRESSINGS,OTHER
UNNA BOOT (WITH AND WITHOUT CALAMINE)	BANDAGES/DRESSINGS,OTHER
TAPE PAPER	TAPE,PAPER
TAPE CLOTH	TAPE,CLOTH
TAPE PLASTIC	TAPE,PLASTIC
TAPE FOAM	TAPE,FOAM
MONTGOMERY STRAPS	STRAPS,MONTGOMERY
TAPE TRACH	TAPE,TRACH
TAPE PINK	TAPE,OTHER
TAPE RETENTION SHEET	TAPE,OTHER
DISPOSABLE UNDERPAD	PADS,BED
INCONTINENCE LINER	LINER,RUBBER PANTS
BRIEF/PANT INCONTINENCE MALE	DIAPERS
DIAPER W/ELASTIC STRAPS	DIAPERS
DISPOSABLE DIAPER	DIAPERS
PAD,NURSING	PADS/DIAPERS,OTHER
POUCH DRAINABLE ONE PIECE CUSTOM-CUT W/ADHESIVE	BAG,DRAINABLE WITH ADHESIVE,COLOSTOMY/ILEOSTOMY
POUCH DRAINABLE TWO- PIECE W/O ADHESIVE FLANGE SIZE 1 1/2" - 4"	BAG,DRAINABLE WITHOUT ADHESIVE,COLOSTOMY/ILEOSTOMY
POUCH CLOSED ONE-PIECE W/ADHESIVE	BAG,CLOSED WITH ADHESIVE COLOSTOMY/ILEOSTOMY
POUCH CLOSED TWO-PIECE W/O ADHESIVE FLANGE SIZE 1 3/4" - 2 1/4"	BAG,CLOSED WITHOUT ADHESIVE COLOSTOMY/ILEOSTOMY
BAG BEDSIDE URINARY BAG	BAG,BEDSIDE URINARY COLLECTION DEVICE
BOTTLES/OTHER BEDSIDE URINARY COLLECTION DEVICES	BOTTLES/OTHER BEDSIDE URINARY COLLECTION DEVICES
URINAL FEMALE DISPOSABLE	BOTTLES/OTHER BEDSIDE URINARY COLLECTION DEVICES
URINAL MALE DISPOSABLE	BOTTLES/OTHER BEDSIDE URINARY COLLECTION DEVICES
POUCH DRAINABLE W/ADHESIVE UROSTOMY	BAG,DRAINABLE WITH ADHESIVE,UROSTOMY
POUCH DRAINABLE 2-PC W/O ADHESIVE UROST FLANGE SZ 1 1/2"-2 1/4"	BAG,DRAINABLE WITHOUT ADHESIVE,UROSTOMY
BAG LEG DISPOSABLE	BAG,LEG URINARY COLLECTION DEVICE
BAG LEG DISPOSABLE, FLIP-FLOW	BAG,LEG URINARY COLLECTION DEVICE
BAG LEG REUSABLE	BAG,LEG URINARY COLLECTION DEVICE
BAG LEG REUSABLE W/VALVE	BAG,LEG URINARY COLLECTION DEVICE
CATHETER STRAIGHT BALLOON 30CC	CATHETER,FOLEY
CATHETER STRAIGHT BALLOON 5CC	CATHETER,FOLEY
CATHETER,COUDE-TIP	CATHETER,COUDE-TIP
CATHETER STRAIGHT RUBBER	CATHETER,RED RUBBER
CATHETER STRAIGHT SILICONE	CATHETER,RED RUBBER
CATHETER,RED RUBBER	CATHETER,RED RUBBER
CATHETER EXTERNAL W/ADHESIVE LATEX	CATHETER,EXTERNAL URINARY
CATHETER EXTERNAL W/ADHESIVE NON-LATEX	CATHETER,EXTERNAL URINARY
CATHETER,EXTERNAL URINARY	CATHETER,EXTERNAL URINARY
PLUG CATHETER	PLUG,CATHETER
CATHETERIZATION TRAY W/CATHETER	UROSTOMY/URINARY COLLECTION DEVICES,OTHER
CATHETERIZATION TRAY W/O CATHETER	UROSTOMY/URINARY COLLECTION DEVICES,OTHER
CLAMP CUNNINGHAM REGULAR	UROSTOMY/URINARY COLLECTION DEVICES,OTHER
LEG BAG STRAP ELASTIC	UROSTOMY/URINARY COLLECTION DEVICES,OTHER
POUCH RETRACTED PENIS	UROSTOMY/URINARY COLLECTION DEVICES,OTHER
CONVEX INSERT ID 1" - 1 3/8"	DISCS,OSTOMY
ADHESIVE AEROSOL	ADHESIVES,OSTOMY
ADHESIVE CEMENT	ADHESIVES,OSTOMY
BARRIER OSTOMY TWO-PIECE FLANGE SIZE 1 1/2" - 4"	PROTECTANTS,SKIN,OSTOMY
BENZOIN	PROTECTANTS,SKIN,OSTOMY
MOISTURE BARRIER SKIN OINT	PROTECTANTS,SKIN,OSTOMY
OSTOMY PASTE	PROTECTANTS,SKIN,OSTOMY
OSTOMY SKIN PROTECTIVE POWDER	PROTECTANTS,SKIN,OSTOMY
SKIN BARRIER	PROTECTANTS,SKIN,OSTOMY
SKIN PREP (BARRIER)	PROTECTANTS,SKIN,OSTOMY
BELT OSTOMY	BELTS,OSTOMY
OSTOMY POUCH DEODORANT	ODOR CONTROL PRODUCTS,OSTOMY
BAG IRRIGATOR W/CONE	IRRIGATORS/SETS,OSTOMY
IRRIGATOR DRAIN /SLEEVE	IRRIGATORS/SETS,OSTOMY
STOMA CAP	CAPS,OSTOMY
ADHESIVE REMOVER	OSTOMY SUPPLIES,OTHER
CLAMP BAG	OSTOMY SUPPLIES,OTHER
BAG FEEDING W/TUBE	BAGS/TUBES/SUPPLIES FOR ORAL NUTRITION,OTHER
IV SET SECONDARY	INTRAVENOUS SETS,OTHER
SYRINGE, LUER LOCK	SYRINGES,LUER LOCK,INJECTION
TUBERCULIN SYRINGE	SYRINGES WITH NEEDLE,INJECTION
INSULIN	SYRINGES,INSULIN,INJECTION
INSULIN LOW DOSE	SYRINGES,INSULIN,INJECTION
NEEDLE	NEEDLES,INJECTION
NEEDLE PEN	NEEDLES,INJECTION
APPLIANCE CLEANSING SUPPLIES	SUPPLIES,OTHER
AUTOINJECTOR (FOR  MULTIPLE SCLEROSIS MEDICATIONS)	SUPPLIES,OTHER
BOWEL MANAGEMENT TOOL	SUPPLIES,OTHER
CATHETER SUCTION 14FR	SUPPLIES,OTHER
CONDOM FEMALE	SUPPLIES,OTHER
CONDOM LATEX LUBRICATED	SUPPLIES,OTHER
CONDOM LATEX PLAIN	SUPPLIES,OTHER
COTTON-TIP APPLICATOR STERILE	SUPPLIES,OTHER
DIAPHRAGM	SUPPLIES,OTHER
ENEMA BAG	SUPPLIES,OTHER
FACE PLATE	SUPPLIES,OTHER
FECAL INCONTINENCE COLLECTOR	SUPPLIES,OTHER
GLOVE LATEX NONSTERILE	SUPPLIES,OTHER
GLOVE LATEX, STERILE	SUPPLIES,OTHER
GLOVE VINYL NONSTERILE	SUPPLIES,OTHER
IRRIGATING SYRINGE CATHETER TIP 60ML	SUPPLIES,OTHER
IRRIGATING SYRINGE,BULB CATHETER TIP 60ML	SUPPLIES,OTHER
LAMBS WOOL	SUPPLIES,OTHER
LANCET	SUPPLIES,OTHER
MASK,SURGICAL	SUPPLIES,OTHER
MEDICATION ORGANIZER	SUPPLIES,OTHER
SHEATH HOLDER WITH VELCRO/FOAM	SUPPLIES,OTHER
SKIN CLEANSER, INTACT	SUPPLIES,OTHER
SPACER-INHALER	SUPPLIES,OTHER
SUPPLIES,OTHER	SUPPLIES,OTHER
SUSPENSORY SUPPORTER	SUPPLIES,OTHER
SYRINGE MAGNIFIER	SUPPLIES,OTHER
TONGUE DEPRESSOR	SUPPLIES,OTHER
TRACH SUCTION KIT 2 GLOVES 14FR	SUPPLIES,OTHER
TRACHEOSTOMY CARE KIT	SUPPLIES,OTHER
TRACHEOSTOMY TUBE	SUPPLIES,OTHER
TUBING LATEX	SUPPLIES,OTHER
WOUND CLEANSER	SUPPLIES,OTHER
YANKAUER	SUPPLIES,OTHER
HYALURONIDASE	MISCELLANEOUS AGENTS